01000000000000101111001010000100000100000000000001100101011000110110001100001001110100011000101101000
01000001100100110000000101111000100000001010111100110001101000000011000010011001001001001010111011000
00011010010111000000000000000001100101000001000101110001000001000010101110000001000001000010000101000
10000110000110001010010110001001001000000001100000011010000000110110001011101000001110001010000000100
00101001100000010011001100100100101001011001001010100001100000000001001000000100010000000101000001011
00100000000001011001001001001110101000100100001010010000111000000100000110000000110011011000101110001
00010111010000001000110010010010011000011100000000111101001000000000010010100100100000100110010010100
01100001110100000100000010000010010000110000001110100100100100110000010000000000110100010000101001000
01000010000010100000010001000000001100101111100010010010100101000000011000010000000001000101100000000
00110001000010011010010101000010000100000101100110010110100011010100010001101110001001000000100000100
00001011001100100110010100000110001000000010101010010100010000100011101001011110001010100100101000000
00011100100000011100000101100011000001011000000010010011101000110001010100000000000000000000000000000
00100111000001101111100001010011100000010010011101100000100010010000100010000000011111000000100001001
10111010010010110001100000001000101000000101100000000000010000001011011001001000001101110000100100101
00000000000000000000001101101010000110000000001001001110001101000100100011000000001000000000110001100
00011000100000000110101000000001000000100010010100000100000001100000001011000010010100000011000000000
01100011010000000000010000000110001100101000011001110101010000011111100001000100000111100101100000000
01010101010000000101000001000001100101000000000100000101011000101001011110111000011011010010000100010
00000001100000101001000100110101001100101010001001001000010010001000000110000110000000100001000010010
00010001110000100000001100000000111010000000000100000010000000000100010100000000001110000111011100010
11001110000010100100011101100001111101001000011101011100100000000111010101100100011000011111101001000
00000000000010010001111100100101001111100011010100110001001010001010001100000001000000000101000111000
00101100000000010000010001000010010001000010000100000000010011000100110110110010010000001100101000100
10010000001000100000000100100010010001011101010100100000010100000101110011100011110100010000000100000
00001100000010000001100010001000000101010010000000010100100100010000100000010001000111110010100001100
01100000000011101010100110110001010000000010010011001010011010000100000000010100100100100010100000011
00000110111001000010100000010010000000010010110000100000000010000000000010100001000101000000000100010
00000100000101000100001000000101000101001000110001000000101001010101000011001000100000001000110011100
00000000001111110101100001010000010101011000000111000101010010010000010000101001101000000000001101000
00010110000000010011110000000100100011000000000100111010100001000001001000000001011101100000100100010
00111011110001011000000000100010001000000110011001111001001100101000000000000100100001011010010011000
01000101001100010100100010000000000110000101100110100100110001001100101100110110010110000000000010001
00000010010000010000010000011010010101000000000001111000010000000100001100110010000010001110000001001
01001100011111000000001000010000100110011000110101001110000001001100000001001110100000111000000110010
00001011001000100101110001111001101000001000111000010000000100001110000111000000001001111000010010000
00000010010110010000100001111001001100000100010010001010100000100011100110101101100001100000100001000
00001010000001000010010000001101000000010001100000000011001010000010000000100100000011001001000011101
00001010110111100010000100001000111010101000100010000010000000011000101001100010101001000110001000100
00100100000011100000000101001010111000010000010010001000000000111000000010010001000110101000011110010
10010100100011000000000000000100101001100000001010101011010011111000100010000100000000011000100000010
00101101111100100000001011101111000010000011101000010001001010101010010000101000000010010000000100001
01011100101100010000011001000110000100000100110001000100001100000001010000000001000010001010010000000
00010000110000100010100101100000100000000000000010000100000100000010110000011000101000000010000000011
00010010000001100001010000000100000000000001010110001001000000000100100100100000010011001100111010000
00001000010000001010001010100011000000100000000000110011010010000000001100000010000000100001001010011
00100000101100010001010111000100100100000101000000000010001001010100001010100010101100010100011010010
01100000010000000111110000110001010011010111001010110010110001000010110100000100110011000000010000110
10001000000010011000010100010101100000100101100011001000100001100100001101001001000000000011000000001
00000000100001000111001001000010100100001000100010010100000010000100010010011000000001000000000001111
01001001000000001100100100010100101010010010010000100000001111000010100011100001100100010011000000001
00011001000000001101100000000000100011000011001100001000101110100100000011110000110011001001000000000
01110110000000000000011011000001001100010001100110101000000010001010001100001000101001100101110000000
10101111000100010000000000001101000000011000000100110011000110100001001010100000110110001100111111000
00100101000101001101000100101010010000000001010110000110001000000000000100000000000011010000000000011
00010001100101000001000111011101000000011010000001000000100110100000100111101001000100010000001100010
00000101000000000010000000110000010001111100000100000000000100010000000000000010110100000010000000000
01010100100010000100000100011001100110100001101000011011010101000000000001000010000110010001000000000
10000010010000001011100010010100001100010010001000000011110110000001000100001100000010000100110100011
00010001101110001000000100010010110100000010101011100000000110101000101110000000100000000001010101100
00000011011000100000001110010011000101000110100001001000100000010100101101000000000110100100000000000
00000100000010000010100010000000010000111100010100010010100000000000000001011101000010100000100001110
01100001000000101000000101000001000100000011010000110000110100110001000011101011000001110000000010000
00010011010010000000100000011100011000000000100101000001101010000001100000000100100000100000101000000
00110101010000101001100000000100000011000000000100000000100000000000100001100001000010001000000100001
00001110011000100000001100000000010101000010010110000110100010000001010101010010010000101000010000000
00101001000001100100100010101001010000000011100100010010100000101001000001010100000010110000110001011
00010000101000000110010000010000000110011010101011000000011000000000110101101010001010000100110100000
01100000111010000011110011000000100110100001000010000111111001000000000010100100100001101100100111001
00001110111011000000000100100001110000001011100001000110100100010100000001001000000000100000000100100
00000000110001000010010010000000000101100001000000000001010001100011100110101001101000100000011000011
00001001010101010001100001000101011111011010111100001000110000100110101101001011000110010000000110000
00101000000001100010011110000000010100000000000100000101100000000001010001000000100000000000100100100
00000000011001000001000001000001010001000111010100100000100011000000100011000100000111000110010000111
00110101100000001000001000010101000010000000000000000001110001010100101010100100000000010100100101100
01000100111001001101000010001001101110110100100001011000000000101110010001010000010010000000010010001
10100001010000110100100010001001100001111100010100000010001010000000100000000100101100000010010100011
11010101001110000001010000001001100010000000101110101010110100000000001100100000001110100100000100000
01000000000000000100000000000000010000010000111000110010101011011011101000000100010000100000100000100
01000010011100100000100010000000001000010010110000101100110110110111101001000010001010000101010000010
00100010100000000011110100010100000001000011011110000000011000000000000000000110100100000000010101000
00100010000100000010100000000110000101111001100110000000100111110100001001110000000000000110011100100
11010010001000001011100110100001010001110011000011100000010100000000011001000000000001001000000011100
10110110000100100100001110000100000001000011111000001000001010000100000101100000100000110000100011101
00000010100001000000001000101010000100000000000001000000100111000100010000001000001101000110000000100
00001001010000000100010100000001000000000110101010001100001000001100000100010011000000100000100000101
00000011011100000011101001100010000100010011000001000010000100100101010001000000110110010101000100010
00100010010001100111000000010100100100000000010100100100000010101000000000001100111000000000000100010
00000100000011100001010100101011000100100010000010000000010001101001010110000100010100010000001100010
10000000100101110000000001100100011010100001100000110100001100100011001111011010000000001011010000111
00010000110010100110000000000001000000010010100001000000000110000100100001011000010000000000000001000
00011101100101010001010010101000000001100000100100000000010000110000010100001000001100010011010000010
10100000100000010000000001000000000001100001000001000110001010010100001001010000011000001000000001000
11110001110100100001100111000001000001111010000000110000010010101000100010100110101010101011010000001
00001100000001000000011010000000000000000000011010100101100000000110000000000010001011000000000000000
10100101010000000001010010000000100000011000000010000001011000000010010011101110110000111100000100000
00000010000110101001111010100100000110010100000010000101010000010000000000000010000000001011000100010
00010100010000000100001011000100010001001000100000100100001000110011001000010000100000000001000000111
00110110000000001110100110010000000011000000000000000100010010000100100100100010000001100011011110100
00110101110100001001010110000000010011101110000110001000011000100010010101000011101010100010001010001
01110000001110011010100010100110000000000001001110101110100100000000100010100000110001010000110000100
10100000001010000011100010100010011000011010000111010110000000110010010011010000011000010101010000010
