00000000000000001000000000000001000010001000100000000001000001000100010000100000001011001000000111110
00110111000010010000000000101100001001101110001010001000001000100011011011001011110011000010101000011
00110101001000100000000011100000001100100110000010000000101010000001110000010111100101000000000101000
00011110001001010000000100011110001000001011110001000000001000110101001010000000000110011000010000001
01001010110000000000110110000100100100000000000010101010000000000100000010000101111000000000011001110
10110000100000100001000100010001010000100100010101000111001000000100000001000001000010010100011000101
10100000100100000100101011001101001000010110100001011010011001001001010011100100001010110001011100001
01101100011100100010111101110000101010110000100010010011100000100000000010000001110011010000010000000
11000011000010111101011000011011000001100010100001010110011010101000001100000101111000001001000100000
01000101010010000001100101010010100000111001100001110000001001000100111010110101000100110100100000000
10110000010001000001000010001100101100000010011000010111010011110011100101000111010010000000100100001
01001001000010111001001000001001100000010000010001001000101000110001100010001000000010110000000000101
00010100010010000010001001001000001001000000001010000000010110000001010000000000000100010100000001001
00010111100010000010100101000001010000010110100010001011000100001000100101100000000100100000010010100
10100010101000000001000001100010100010001010000000000000000000100110000011000001011001010100100000001
10010100001001011000100000100000000001000001100100001011110001010000001100000011100000100001011000100
10010101000001110000001001101001110000001001101111001000001010000000001100001101010000000000010100000
01000000100011001100000100000100000110000010000111000100000010000000100000000011100010000001100001101
01010001100101000110000001100001000100111000000110000100000001001000010010101000000000001010000010101
11000001010000100000110000000000100000010000010010000001100001011000001000100001000101100000100010001
00000100010000100000000010100000000101100000111010010010001010100000010111000000000000111010000000000
00001001100100100000000010001100000001000000010000010001001010011000000100100000100100000011010000010
00000010000000110000100101011000000110000001000010010010010000010100000000011010011001000001100100010
00011100100011100010010011010101001101000100100110001000001000001011000101011110100100010000111110010
10010111000101001101000110100010101011101000010010000001100001010000110010000001001000000011101000010
00010000100101110001110001000100000000101001000001010100110000100000100000001111010001000001000000011
10000000110100001001000000100000110000001000001100010001100000001010000101001010000000000010010011000
11000000000010100000010010010000000000000101001110010010110100010011000010000100110000110000010001001
00000010011010000000101110111000000100010000000101000100010000100000100010000100010100101001000100100
10000000011000010000100101101000000000000001100010011000000000100001000000000100000010001010000000111
00000111100001100000011011000011001000011001001000000000101010010000001101000011100000010110011011100
11010010100001000001000101000000000000001010000000000000000100010001000010111000000000001100100011010
00011010001100001000000000000010001001101001000000110000010010000001100001001000010001110100001000000
00100110000011101001110100001101000000100011100100100100001001000100100000001011001000000000000010010
11000011000000010000001000100000000101101000000010110000101010101010010000000010110100001001000001101
00000101010000100111011010111101000010010100000110001011100011001000001101000110000000111010000100101
00001100000100101000010101000011001100000010000011000010100001110001010110000010000101101010101010001
01011001000100100000100001001010111001000100001000001001100000100100010001000100000000001110000001101
00010001000110010010001110001010010000000101111001111101110110000010011001000001000000001011110001010
11101001010010000110000110001100101001000100000101001100000111001011000000000000011010111000101010010
00000000000000000101001000010001000101110110000000000011010010100000110010101100001001000010100101010
10000010001001011000000000001110000100010011101010010000100010010000000010001100001000001110011101011
10010101000000000010001110100000000000001101000000100010000010011001011010001010000001100010100000100
10000001001000100000101001010001001001000100001001100000000010100001100000100000110001100101000001000
00010000000001000000100100010000101000001000000010100000011000000001001000000000100000000001010000101
01100001000000010000101101100000100000100101000000000111000001100100101101011000101000010000000110000
00101100010000001001001000010000000000110000001100010111100010100101001000100000100001010001000001000
01100000000000101100100111101000010000101011100000000100010111000000011101011000000000001001000000000
11000101011011000100000010010011000001001001001000110001110000011100000001000011000100010011000011100
01000010001101001101110010100010101000011010001010110000100010000111010011111010001001011000000010110
10011011001000110000001011100000001000100010001001000000000110000100000100000000010001010000000100000
01010000100110000001000011001100000000000010010011000000000011010011000001011100000011100011001001011
10001010110001110101000000010000100000000101011011110000111100000100100101100100000010110000001010001
10011011000010110001110100001110101001010000011010101100100111000000001011010010110100000000010101000
11010000111000011000100000100001000001100101000010010010011110100000010000001010101100111100001010000
00010100101011110110000000000000010001100101010000001001000100110000011000010100000000110010000111000
00000001000000000000000000000100011010100001110010000010001000100010000011010100010000001000001010101
00000101110100010100000010000000100000001000000000100001000011000100100010001001000011100110000001000
00001000101100100101010000010000100100001000100010001001101100000000101000001111010001000001000001110
00000001011000001000110011100100010100011000100000110100010000000010000000111101001000000011010000000
00010001001010000001001000000001001000000010101110011100110101100101000010100000110001001000001000000
01110000000010100000011001100010000010010100001100000010110001000000010000001100000100000101011000001
01000000010110110000000010100010000100110101010001000000001100100001100000110101010110000001010000001
00000100000000101010100011011110000001111101010101000000010100010100101000101101101111110100000010001
11000100000110010000110101110100011100000100101001010000000000000100000100100001011001010000000100100
10010001010001101001000110001001000010000010010100100000001000111011100110010110011000101010110101010
00000001000100001011000101010111011001001010101100001110010001110010000110110010001100110100100010000
00010101011110000000000000110101001000001101000000101100000001000001010111001001010110000110011000000
10000011000100001001000010011010101000011000010111010101111011000010101101000000101010001001000000000
01111001011000100000101110110010010100010000010001101000011100000001001010001010100000110000100100101
00000010001000000010101100000000000100100000010100000011001101001100010000110010010100000010100110000
11000000100000010101001010001010010001000010110001101101100010000100100110011111000001000010100100000
00010000011100010100000100000000101100010011000001010000100100000000010001001110010000000000000000010
01010000001110010000010000100000000001000101000001100010000000000000000111011000010100000011010010000
00000101000000100000101000011001100010000000011010000100100000010010000111111101010000011000101000100
00001000001110010001001110000000101010000110101100010100001011001001000000110110000100001101010000001
00000100101001011110010001010101000100001000000101100011100001000010101000000100000110000010110000001
10111111110100000010100001010001100110001110000011011000000100011000110000111101000000110100000000011
00000010010000010000001000001000000000000010001100000010100100000100000100011001100001111111000010100
00100010110010010101011010000001010000001011001010010000100000001100001001111010000001010100100010010
01000011001000001100001100001000000000011100000000110110010101011001010101101000111010010000110100001
10010000100001000000010010000000101100000011010000100000000000100010111001000000001100011010000001011
00100000101000010001001011000001000000100000000000011000101100011100100100000000110001000000100010010
00001001111101000101100010000001100101010101010001000000001000010100100000100011000000011011001010000
00011110101000010110100001110110110000100100001000010000001100000101010000000001000001100001110100100
01001001000000000000011001001000001001000001100011000001000001000010100000000010001011000001011000000
01010001101100100011011000001001100010000011001001000010001101101000110000000100100100000001001010000
00010000010101101000010101101000000001010110001101101000000000000011010000010011000101011000001001011
01000101000001111010000010110000000100010000101101011100000000010110111010000010000000000101000000000
00000000010010001100010010010001000000100011100001010100001000001001000100001000000010011001100000000
00100000000001010111100010001000010000100100001001010011100000111000001000110001000101100010001001110
00011001101000010000000001110000101100001010000011000000110000011001000001100001100001100100000011100
00101000001110011001100000000011110000011000101000000001000000110010000101000110000000101100000000111
00000100101000011001000001000100010001100010000011100000000001010011011110000001000000000001100000000
00000000000110100001110011000000000000001100000000110010000001010100000010000010110000011000100010101
00000000010100001000110000010000001010010000001000000001000010010001010000000001101000101000101110000
10110100000000010011001110001000101100100110000000000011101110000100100100010000000000010011001111000
11000000100111000000001110000010101000000010000000110000000000010010010010000101000011010001100010001
00000000111000010000010110010000001010011110001001001100001100001000000000010000000000101101000000010
01000010011100111010100000100000010000000000000011110000010110110001000110010010000010100100010011111
11110000000110000000010100110100000111110010110010010000101000000111110100000000001000111000100101011
