00100001001000100000100010000100100001000000111100000000010010000000000001000011000000000001010000001
01000010100100100101011101000001110010011010001010010110001111000011000100100000101001000000001100011
00110000100001111101000000000011011001101100010100100000001101001000000101110000010100011100010000110
01010110010000100001100100000000001000110011100001000110000100100100001000000010100100101101111001011
00010000100001000111000000100010010110010000110011000101100000001010111010000010001100100001000100001
10001000110111100010000100010001010110001010000000100000000001000001111010110001000000010010101110010
11101001010000000000000000000010010100000001001000000001000100110101001100011101101000001011100010001
00000010011000110000001011000001010100000100110100100000010000000101000100000010010010000001100000001
01100000000000000100100111110000100110001011001111000000000001010101100110010001000001001000000000100
00000000000101000000000011000000001000101000000100001000000100010010010100000000000000100001000010000
10000001011000010010000000000110010000100001010001010000000000011000001010001000101000000101001000000
11100100011100100000100001100110000001011011001111000010000000000000000000000000000000111000000111000
01000010001010001000000000100001000100011011011000000000111000100000001000000011000000001001000010100
01010010100100100101010000110000110110110010010000000001100010110001001001000000000000100100010000011
01000010000000000011010100100000110000110000101000101010110001000000011000010010110011101010000010000
01010000000010010100011010100100000010010100101000100000001001000010111001000000110001001101110101100
10100000000001000001000000000000001000100000110000010010001010000000010000110000001000000001001001000
00000001010000101000000010010100100100010001001000011010101010001000000011001000000101111010000000000
10001000000001000000101101000000111000000001000010111000000100101100010011101110001101000001110011000
00000000011001100000100110000010000010000000011100100000000011011101100100000100010001001011110000001
00000010100000011000000000010110001000100110000000111100110100010000000001000000000000011010001001001
00001000000000000010000011100110000000000000000000001010001000100100011100011000010000000001100110110
00101100000000000100000010000010001100000000000001000011010101001100000000000000010100000010010000100
10100100001011000011101111100000010000000010010100000000000101111110000000000110000000000010010001011
00000000011001000001000010100001110100000011010110000100001001010000000100001000010101010110100000010
10101000110010100001011001011000000000000100110000001000110000000100010001001001111010000100011101011
00010011000000000001000000011001010001001000101011000000010100110111001000010100010011000000111010000
00000100101000001011100100011011100000000001010001000000001011110100000111101100010100000011000001100
11001100110100000101001110100011000100001110101001100110000010110010100001011010110010000000000000100
10011100010001000010100000000000010010000000001010001101000010100100110000001010101100010011010010000
00010000001100000001010000010000010000010000000101111000001010100001001000000110100000000100100001011
10000100000101001101010001001101000111000010000010000111001000100101100000001110000000100000100110011
00000100001011010000100011110001000001101000000110000011001000001001110001000100111010000111100100010
00000111100001100010010110011001010000010110110001110011100100000101000000001000100111100000110000011
00001000010011010000010010011000111011110110000000001011000101101011010001000011100000000100100100110
00000110001100001000000010010110001000111000000010000100001110010000010001000010010010010000010110110
00100000101010000100111010000110010100000011000000001000111000110000000010001110000000010000000001001
01000100000101001101100000000110000101100000001101010100000010010100100100011111001100100110111000100
00100100100000000000000000001010100010000001101000000000000100000001010000100100010100101100011100011
00000010001101001101001000100111100110000110010000100000001101010000000100100001110011110000000010100
00000010000010101000111000000000010001110010000000110110000000010100101010000011000001111011000011100
10110010001101100000000000100100000011000111000010000100001000000010110000000000100000001100000110001
00010000001000011000101100000000000000101001110000000001000000001001000000001111000000100000001100000
00000010100001000011100000100100000011000001000010000001110000001100100000000101100000011001010010011
00101001010010000000010000000100000000001000000100000010000100100100100001010100001010100000001010001
00001110000000000000000010100010001000010010010010000000100001000001000000010000001110000001111010010
00010100100101000000101100110000011000010000000000000000100011010110110000000101011010111010111000100
00001010010000010000011000000001100000000001000110110000010001101001100000101000010101100000000000001
10100011001000000000100010001000000000010000001001000011000010100101000001000111100000010000001110000
10000001011000000011111000100000000000001000100000010010000100001001100001100110010010000011110001000
10000110010000011000010001000100000110000110011000001010000001101100001000111011000010000001001000011
00000000110011000000010010000000010100001001000110000000001100000000010000000000000111000011011110100
00011000100101000000100100000000101000110000100010100101101001001000010010000100010000001100011010000
10100010010000011101001000001111100010000100001101010010000001100100001100001000110000110000000000100
00000000000110000111010100100001011101110000001110010000100000000000000001100000010000110000100110000
00010000000100100001110100010000000000000100100110100000010000000000001011000000000000000000000000100
01000000000000000000000100110111101001001110000010010001100110100011000000010000101010100001010000100
10000000000011011000010011001000000000000000100001010110100001011000101000010000000001001100100001101
11000000000000000010100100000001000010000100101001000001010000110101000010001101010000101101000101111
11000100000101010000010000001001010000010000000000001000100010000001110000100010100100011010000000000
10000000011000000010011000000001110011000000011011010010101000000011000010001010000011000110001011000
00000001100000000000101001000010001011000110001001010111100001100101011011000001010100111100001000000
10000010111000111000110011100000001001010001010000001100001000100010011001100000010110101000001010001
01010100110110000001010101000100011000000010000001000010001011010000000111101011110100000010110111011
01000010001011000010000000110101110000001111000100000001101000100100000010001001010110001000101010000
00000110001000010000010101010100000001000011001110000000000010010001111100000000000000001000100011011
01010000100011101011001001100010000000000001100011001000000000010010101000010100000100101010000000101
00001010000000011001101101000101000000011001110110101001001000000001101011000010000000000100111100010
01000000000000101110010010000011001110010111001100101001000010000000101101000000000000000001011000110
01010100101100001101110110000001000110100000100000000110010010010000100010011000010011100010000101101
01101000001110000010000000101000010001100010100101010000100001000000010011110110100010111000000100001
10101111000000001010000000100100100000101100010100000110100000000000000010000000010000000001000000100
10000110000000001011010011011010000000000000000010100010000101010010000010100000101001100010010000010
00000000111000100001010000000100000011000000010000001001000000000000010000001100010000000100010011000
01001000111000000000000100001000000000100101000111011000000101011100000110100000000110100000001100101
00110000000010000000000100111010100100010100010001100001000001001010100000110000000010111000101100100
00000000011000000100011110000001000010011101100010000001000100011010100000101000001101000001000000000
00100000001110010010001010000001111100100001000000001010010000100000110000010001101010010111110000001
10010000010100000010001000100010000100100001010110000010001000011000001010101010010100101010010000000
01000000001000100001000101001001001110000001100101110011001000011100001001000100010000000001110010000
10001100001100000001100110100001000001001000010000000000011000010011100100000100001001010001001010000
00000101111100001100001101011011010010101100100100000000010011010011010000110001011001100000110110111
00010110011010000100100110000101010001111110001010011011000000101010001000000100010000010000000100000
01001110000100000000100000101010100000000000100000000000000101000001101000010000000001110000011000010
00000000100100110010010100000000010000000110100010000000000010000001000010000000001101100110010010001
01000100000101000100000011011000101000010000100000110101000000110000011010100000110011100000101100110
00101000001111100010010100000001011110010000001001001000000000100100000011001100101000100000000010110
00000001001110100001010000000000000110000010011101011001001010100000000001000000001011100110110000100
10001110000000110000110100000000001000110000000000100010000010101000001000000011000100110100001000101
00001000001000000000010111000000001000000000000000000000000000100000001000000010010000101000000000010
01001011101101000001010000000000010001000011000000000100010101000010011000010000000001000000000001110
10100110000010000000100100011110010000000011101000000010110110010010111000110000100000001000010000010
00010000100000100010001010000000010001011000000001110010110000000100010000000100101010100100101101010
00100101100000000010000001100011000000010110000010100110000101100010010001000100000101110001100110000
00000100001011011100100000100000000000001000100000000000000000000000000010000100101000001010010101001
00111011000000001100101010001010000000010000110001000000001000100000000000000000000010100111100000000
00000011110001001100100001000010110000001100000100100101000000110100010000000000010001001000000001110
10000001100000000000000000001000110011000110000000000010000000000011001100010010011010000110000001000
01000000010000000100100001010000100001001011000100010110011010100011000001000100000000101100010001110
00000101001000110000000101000000000000011001100101000001011010010100010011000001101001000010100000000
10000000100001010001001000010000000111010110001101000001010100100110100000001110000001010011110101010
