00100001101100001010100000111110010101000000010001010100101000101000000000001011000110101001100000110
00001010000100000101011010000010011000010001001010011100000111100001010011001000110010010010010000101
10100000000000000000110100000110100100010100101110000010100000110100111101111011000011100000001000010
00001110100100010010110001000010111101000101001100001000110001010000101010001011001000000000100110000
00010000101000100001100000001100111110101001001110000010000100000100000000011000100000001011010010010
01110000000000010000100000010000000000010001010000100000011001010000100000101010000100010110000001101
00000001001000010001111000000000000000000000011001000101011010001001110010000000000010100110000111100
00000000011100100000010000010000000000001001110001000011000111000011010000000111011010000000000000110
00001001001001100010000111100000111000000000011000000000100100110100010010001000000000110101101010100
11101010000000101011010001010010011110000000010011010101001001000000001010100011010111100011001000000
10100000010000010001010000111100110010110000000001000010000000000000010001000110011110000100000101010
00001100010010011100000100001000011111111100000011010011001000001000000000100000000100000101011000000
00001001110001100000010000000000000101001011100010000000100000011101000100000100000001100000000010000
01000100000000000101010000000001011000010000001100100000001010010011000000000101000000000011010010010
01100010000000111100011010001000010110100000000010000000001010110011011110010000101100000010110100010
00101000100011010010000111010000001110010000001100000100100011001110000011000100111001000000111010101
00000010000100000001010001100010010110011000100010000000000011000001010000111000000100000000000000000
10000010110010000100000000000000000000000000100000101010000000010101010010010000000010100000110100000
00100011100000101100010001001010011010000010010101000110010101000010010001110010000000001000001010000
10001001100000011010000000001111000100010100000100000001010010111000100100101100000110010100000100000
11101000001000011000001011000000100001000000000010110000000100100000101001011100000000001110000000011
00001110111010011000101110000000001000111000100001010010011010100000000001001101000000000011100000001
10010010100101100110010100001001000010001000000100000011101000110101001001010010100000000101100000100
10000010101001000011010001000100000110010011001010011000101001001101000000100000001000000100011001100
10000000000000000010111001000100000100000000000100010011101100000010000011000100110001000001010001000
10100000110111000000001010000100110000011100000100000010100001000110000000000110000101000010000110100
00101110011100001000111101000100101001000000000000100010101101011100100100100110000000000000010000011
01000001011100100010000000001000011010000000001010000100000110100100001000110100010000100010000011100
00100100011100000000010000111011000000100001001011000100010000000000000000000010000010111001110000101
11101001010000001100100000011001001000000011001010100010000010010001101110010010000100000100000101011
11001000010100010000000001101000100001010001001000010010100111101000011000000100000010000001000000110
00010000100011110000000010000001001101000100100000000010110001101110010000000000000000000001000100011
00000011100000000100001000000000100000000110011000000000000001010001100100111001000100101001000011000
10010010100001010001010000001010001000010101000000100000010000100001000011000100000001101001010101000
10000000101000000000111000000100110000000000000000001001001000101000000010010100000010001010010001100
10110100000010001101100000110000100110110000110000100001000000100001001100010000000100100010110001000
00100000100100010100010000000001001000011110110010000000011010000000010101001001100101000101101000010
00110000100110001000100000000000110011011001100010000000000000100001001010000000010000000000000001010
00000100100100100000000001100000001000010000110000101011000001000011100000101011001000010100000110000
00000001100100011000010000111000100100000110101100001010000101100000010000010101101001000101010100011
01101000001100010100001010001000011100010010010100001000000111011000110001001101000110010000101001000
10011000001000000000001000000000010110010001000100010000000000011011100000010101000000100010001000111
01100000010001010010100100010000010000000010010000001000100100001000100100100001110000111010110100010
00000000010010001001010110001100100001100000011000010000110001000100100100100000000000100000000000010
00000000101000010000000010011001101111000011000101000001000010001010010010001000110000101011000100000
10000010000011010000000010111010000110010000010010000000110010010001110000010000100000100000000110000
00000010110000000000111100001000000100010111011000001000000100000010001010000001000010000000100001000
00001101001100101001001110000100001011010111010010100000000011101101000001000000011000010000000000111
10001001000000110000101100010110100100100100110010010000000000000001101000000000101010000110010000010
11000011110000100110000000111010100000010010100010001000001010100000100011000000100010000101110000101
01000010000101101010011000011000000000001010000001001011000000000000010010100000000000100000000101001
00011001000000010100001000000101000000111010011011011000000000000100010100011101000010011100000101000
00000010000110010000011001000000100000101000001001000000000011001000000000001000111110010011011110000
00011101000100010001000010001100001000000010100000000110010000101000010100010000000110110111100011010
01110100111100001011000001000000010000000111100001110001000000000010100000000100011011110110111010000
01100000101000010100000001011001100001001000010100000000000000100110011010000001010001100001100100000
00001010100000000000000100011000101000011001001000010100000001100011110001101100110001011001001011011
01000101110110110010010000010000100000100000001000010100000011100001000000010100101011101100011000010
01000001000001010010101100101100001000010010000000010000001001000000010010000100000000100000100100000
00010000100000000010101001010001110101110101010000000001010100010000101000001000101000000001101010000
10010000000011000101001000011110000000100111100110000010100010000000100000100000000000000000100001100
10010110000001000010000000001000001000110011000011001010110011000000001010100001001110010010010101010
00110000001101101000001011111001011110010010001100000000000111100001010011000000100000001001100010100
01010100001111000100000001010000010000001001001001100000001001100000000100000000100000110101000010000
00000100011001101001011011010000010000011100001100001000010000010100110100000100010010001110011000001
00101000011000010101000000100101000100011110000001000000000010010110101100000001010000110000010000001
10000010000000011110001100100000110010010010011010111010100001010110000001000011000001001000110011110
10100000000010100000000000000011000001010001101000010101000001100100001011011001100100000100001011010
00001101000000000001000010010011011000000010001000100000101000100010000010000000100010111000101100011
10100000101100000011000001001100001000000000101110101000000100000000000000000000000000000000010100011
01110000001000000010100000110000101001000001001000011001100000100011000000100000000001000010100100100
11000000100000000000101000011000001100110000000010000000010001000000000010000000000000000000000000100
01000111001011001011111000000000010100000000010000000001000010111001010100100010100000100000010001000
00100001001100000100100100010010011110011000110000001000100001000000011000000100000100001010101000110
11001000000000100000001001010000001000000000001000000000000000011001001101111000001010100000100001001
00000001000011111101000000000000001101001010010000100100001100101001111010100110100111110000011000000
10000000000100011010001101000000101000010010011010000110000100000000000000011000110101000011010011110
00010000100011010010010000101100000010010100001010000000100000000010000000000010111000000110001000000
00000000010110101111000111010000010010000000010110000000000000110000000001010111011000101000110011010
01100011000011100001000010010000010010111000000100100110011001010100001000010100110100110011011011010
10010010110000100000001001000000101101110100001101001010100000100110010100100010101001000101100001000
00000000011000001010010100001110000010010000000001001001000100100000000101111000110010111100100010111
01010001001100100010000011000000100100000000111010010000010101001000010100001000010111100101010001110
00010100001000010000011001000000010001011001111100000001000000000011010001000100011111001001010001000
00000000000000011100110000110000000000000000100100011100100000000100110000000000000010000000100001001
10001010000000001000011011100000010001100010001000000000000001010000000000011000100011000000001110000
11110100011000100110000100100101000001101010000100001010010100000010101100010010000100010000011000011
10010000100000100100001000110001101101000010001011001011100000100001010001011010001000000000011010000
00101101010001010101000000000110001000110000000100010001011000000000110011000011011100000000100101000
10010010110110001001000000100000110100011100110011001111101000100101100001000101001000111100000000001
00100010101000000000000000010101101011010000000000000011000100100110000100001100100100000001000100000
01001001001110100101000000101001100000001000000000101000001100000001010000000000100010101100000100011
00001001000001110010000000101000010000101010010000001101110111001011000000101100000001000000000010000
01000001111000000000000000010010010010100001000001100100000011100000110010010000001010011011011001010
10000011001000100000010001100001000001000000000000100001000000101101001000000100011110110000100000000
10000010000000100101100000001000011100101101000000100001100000000110101001001100100111100000000000101
10000000010000000101100000100000100100000000100100000100000110000000011010111101000101110100010000100
00000010101101010100000000100010000100011101001010000001000011010000001001010010001100000001101110111
10000010000110100000000100000010010001100000010010000000000100101000100100100100000010000000001100000
01001000000100000100001000111010101100001000101000011011010001100000000110000000000010001100000001101
00100111111000000100100010000001000001010011000010110101101001000100100101100010010000100000000001100
