00011100110000101011010001000101000000000100111000100000001100100010000010001000000001100000011000001
11010100111001001000100101000001001101101000011000000001001011001000001110000010010101100001000000100
10011000100000011000000010111001010001110000011000100000010100100100001001000000000000111000000001000
10100011000100010010000101010010001001100010010001001000000010010000010110101000101101000001000100001
11100010100100010000011010000000100000000011000110100000000000111110100000111111010100101000010000010
01010011000000010010000001001010001001110011000110100000010011001001101010000101011000100011000100010
10000001000000000010000000001110000001000010101001000000101100010000100110000101001111000101110110000
01011001000001100000100100010101000011100001011110001001100010110000001100100010000001001000000100010
00110000110000011001011000110010000100000100101010000101101100011000110001000001000100001011010101011
10000011001000000010001101110000000110001000000010001010100010100001000001100000101100101000000010000
01000010100000000010001111010010100010000010000000011000000100110011000010110011100101001000010111000
01000000000000110111111100000010110000101111001110101010110000101000000001000100010000100100010010011
00001010100010001001000000000010000100001110010111000010010000000001110010000100101000011000100011010
01110100101000100000110101001000100001111011000001000000000010100000100000000000110001001100110101101
00011100000001010001000101100010000010110010100100001100110010100010011010001010011000000010000100000
10100000100001100000010000010001000000100000000011000100100000000000001000100000000001100101010101000
00001001000010000011001100100000110110000000010110000100010000100011000100000000000010000100000110010
10000001100010010000000100000000111000100001100100111001000000010000000010010110100001010010010010000
01011100100010100000000001000101011001011000000000000100000000101100000000100000100010110000011100000
00000000001001011100001000001010000011100001100000011110110000101111100000001000001101000001001000000
00010000010010000101001001001100100110001100101000000100010111101100000100000101001011101000000000000
10000001001000010011010010001001000000000011000000000000001001111001010010110101000000001110010100010
10100010000000100100000010000100100100000110100100000110101001000001110000101001000100101001000000001
10000000100100000101010010010001000001011000000011000000000000101101101011000001000100001101010101100
01011000000101000000000100000000000011101100000001000001000011010010001000100101000010001100100010000
10000000010111011000110000000000100001010000010010001000001001000101110110000111000100111000000100000
10000011000000000001000100101000000110001000110001001000011110100100100110000000000000000000000000001
10100001010011010110000001000001101001000010000100100000101000000000000000011000000000011010111100000
00110010000001000110001000101100101010011011001001100000100100001001011000011010010100010010000001000
01000000100000000000000000000000000001110000000000110001011001100000011100111101000101000100000011010
00010010000000100101000101000101101000010011011000000001110000000000111000000111100001000101000100001
10001000100000111111101010110011001111000000000011111000000000001000000011000010100001110101001010010
00000110000101000000010010000001001001100000111001000100001001100001001000100001001011000001000001001
00001101111100010110000010101110110101010101110101010011000010001001001000000110000100100101000101000
00110100000000000100100010110001110010000111000001100001100000001000000000001010001110001000010010000
10000100000100100100000001010101000000010100000000110010010010000100000101100000011100110101101100001
00110000000000000000000100000000001001100001000001101010011010000100010100000010000000000010001000001
00000010000001101010000001000010010100001111010000100001100001011000100000001000000000010000000110110
10000000111000000111000100100001000001001000010001001010000100010000000000101000000000000000001101000
11001001000100001100011001001111001000000100011000000010010010000111011011010110010000001000001000100
11011001000001100100000001010001100011000001010010100010000001000100010000011100111001100001000001010
00000000100100111100000100001000010010010100101101000100001100010000000010001001000000001000100010001
00000100001100100001000010000000100000111000001010010111000101100000001001100001111000010000000000111
00111011100000001100011011000001101100000000100000000100110010000000000010111010101000011100001000000
00100100011100000010100111000010000001100000011011100000010000100000101100000000000001110000000000010
10101010000000000100000001001000011000100100001000001100001010010000100000000000001000001010100000010
00010100010010100101000000100001100000010111011110000000010010001101010001010000101110100100000000000
00010000000001000100011010010100100000000000011001000110000001010001010101001000010000010001000011010
00010000000010000000000010000001001110001000100000010000011000000110000100001000100000100010010000011
00100000010000100100000100010100000100001101011010000000000000010000110110110110011111100000010100000
10000100101000010010100001001000000000100010100011011000001001010100000001001000000100110000000100001
01000010010000110011011010111001000010000000100010011010001000000100010000000100000000000010001000001
01010010000101001010000010000000000000000000001001100010000000010100000000100010111000100010110010110
01100000001100010101000101110000100001010000100010010001000000101100001010000000000000000000101100000
10110000000111101001100000011000111100111000010001000000010010101000010011110010100010001100110000010
00000001011000000010110101100000010011101000111001000010001000010001000110010000000110101001000001100
01110001000000000000011000100111001001110110100100011010001000000001001000000100101101001101000000001
10000010001010000100001011001000100101000010000100101010010000101100110000000100001000100000001000010
00000010110010110010000000000010100100100000000001001010010101000000100001101010110011101000000011010
00001011001110010100000001110100100000011000000010101010000100000010000010001101010000000001101100100
00101000001001001000101010110010001011000100100010000010000000000000000000001001010101100111100000111
00000000010100100111010001001000001000100010010100001000001000110000001001010100101000100101110111010
01000010010000101001001000001000100000000001011000111001010111101001010010001011001000010100000100010
00011000100000111110011010000100000010100110110000010110000100101000001100000000000001000000000001101
00100100001101110011000100000000010000100000000000010111001010101100001001000100010100000100001100100
01101001001000101010000000110001000010100001001001110000000000001100100110000010001011100010110001010
01100000001001011000000001010000000111000100000000100010000001100000001000000000101001001000001110100
10010010000001110001001110010000111001010001010100010000100010000000000001001001101110000000001001000
00001110000011000100000101000001010001010010000110000001001001000100000000010000000000000100010000001
00001001011000100001000001010011000100011000010101001001000001000000000010100100100100000000001001000
10100100000000000111011000010000111000000000000000000010000000100011011010010000000000101000100001000
11000000101100101100000001001000000110000100000111110000110010010111010000001000111100000010010000010
11001000000001000010100100001000000100000111110100100010110000000000001010001010000010000000000010000
10000000001000000001000000100000010101000000010011000100001100001000000011001000000000000000000001101
00100000010100001001110001111100011001101100100001000011000001100100000000000010000010000001010001010
11000000010111000000001011000000001110000000011011001000101010011011110001000001011100000010000101000
11001000001000000001100000100011100110000000011011000010000010010001001001100010010010100001000110010
10010010010010010000100010001100000000101100000001100001101000010111010100000001010000010001000001010
00101010101011001100010000000001000010011100100010000010001010011000001000010001010001000010000011011
01000100100110010010000100100000100010001010100010000011100000000001010001000001000000100011011001000
00001100000000001110001000100000001010000000000110001100010000000100000111100100000000011000101101010
00000000010001101001000001000000001000000010000100100000100100100000100000000000010000001000000100011
01001110010000010001000100101010000000000010110010001100110001000100000010011000000000000100000100010
00000111000000101010010000000000101010111110001000001000000000111000000010100010011100000000000001000
00000000000000100100000100101101000100000000010000000110001001011001111101010001000000100000000000000
10011110100000110010010100001100111100010000010000010010000010001100101001000111001100100100001000000
11111000000001001001100100000010010110000001010100010100000100110010001011100000011100110001010100010
00010100001000000000110011100000011000100000000101000000000001100100000001110000000000011000010011101
00010010110000000011000000010010010000011011000011000000000000110001010110010000110000010111111110100
00010100010100000010010001000000000000000000101100000001010001000011000010011000000000000110100110101
00000100111101010000000001111010000100010000000000011100000000100000100010010110100000101010000010000
11010010000010010001001010111000000100000011100010101001010000100000000100000010001000011000000010010
00000000001000000000011100100000001010100010000000010001101111011001101001000000000000010001001011010
01000100010000110000000110010001001110101000100110010100000100010011110000101000010001100001101101001
00011100000101000011100010010000101101100001000000100000010111101010001010010011001000000011000000001
00000011010100001111011000001000001110000100001000000000000001001000010010000111010001010100011101001
01000001010000001000001000000000000000000010110010100000001101000000101000001110001000000000000010000
11000000000000010000100100000101100000000010000010000100100000100000110000000000001000000010011110010
00000000010010000000011101010001101100100001101010001011001010010000100001110000011010000000010110100
11011100100011000011110101100011100100100000100100100000011001010001001010000111000101100001000110000
00110101010001001100110111010010100001000001001010111101010000010101100000000010001010000001101000010
