01010101010010100001010001000000000000100101100000001010001101000000100000011000100010010000001100011
00011001000101001010010101100100001100000001110000101010011100010000000001100000110110110001001000010
01101101100100011100110010100001000101100010000000100010000010000111110001000001001001000011110000000
01000001000011011100000100110001100000010001110100001000001110001000100011111101000000001010110100100
00100001101110100000011111110001001100010000000010000100011010001001010100110000110000010000011010000
10001001000101000011000001100110000000111000001010001010100011000000000001101010000001100101000010000
00000010000000001000000000010001001010000110000011010100101000000010101010000000001010010000100000000
01010010110110000000000010101100101000010000011110010010100111100100000010000100010100110100100101000
00000000111010110011000001010100000000111100001010100100101000000000100011000000010110000010001101001
10101010000011000000100000010000011001011110100100010110000000010000010001000001010110000000010001001
01000000000001001000100101010010110010001000001000010010001010101100001100001011000000000000010110011
00001100000000101110101010001000101001100000010010101000010110000110100001100001000110010001000000001
00000000010001011001100100100000000000000100100000000101101001010011100000000000000101001000111010001
00000100000001000000011000000101000101101010110000100001000001000100110000001010101000011100001011101
00110101001000000100001001100000000001010001101000000001101010111000010110010100001110110100000100000
11001000000100110000000101100000100010000010000010101011110100110110110000110110010000110010000010000
11000101010101010000010001010101000000101110000000100010001011110000011000101011000011010000100011000
01101101000010101000000000100001000110100010011000100110001000000000011000110000010010110010001011001
00101011011110011010001010001101000000000011101001001100100100000000000110100100000001000000010010001
11000001010010001000101100101000000000000111000101000000001000101001000100110110011100001001000110111
00101001000001001010011011010101100100100000110000100010110000100000010001100010110010100000001000010
10000001010001000000001110000110010000010000001000000100000100100000111001100000100001011000100011010
01001000100101000001000010010010001100010001010001100001110010010011100000000100101000101100100000010
01000000000111100111011100010010001000000111010100010010110000010010000110000010100100000000101111001
00000110001101100000001010001000010001000101110000000000000000010011000110000011011000011000001000000
00001101000110100100011000111000100001000000101110100001001000110000010000101010000000000110000011010
00001000010010000100100001000011101000000100001100001000001000010110110001011010011010001101010110000
00100010001010000010000001111101011001000000001010101011000111010000001110000010100101100000100000100
10110100001010110000000100001001000000010100001000000100010000001110101000001100000000100001100000001
01110000000100001011001010000101000001000000101001101000111100111011001000110010100010000100111000000
00010001101110100001011000001011001010001001000000100001010101000010010101010010100010000100000000010
01010000000000100001011101100000000011010010110000000010000000001110101100000101001000111010010111000
01001101001010110000010111110000000010010001010011100001100001000111000000100010111000000000000000110
00000100000000101001010100001011010010000000000000000010010110001001001100000110000000000000001000110
11001010000000010110100000000010001010100001010110000101010010010100000100100001110001010100000101001
10001000011000101001100100101010100000100100001001000010000000001011010010000011001010110001101000000
01000010100000001010100010001110000000000001001000001011000000000100010000010100100001011101000111010
00011111010010000001000011010010010000000010111100100101000100001000000000010100010000010001100110000
00011110100000000110000000010000000100001000100101001000000000010011001001100101000000010010110000100
00100010000010101000010100100001000000000000000011000000100010001101000001000001000101001001001000001
00000001100010000001001000000110001000000011010011000010100010000001000000100010001001110100100100101
00010011100101000001000000010001100000001000001011111000010000001001000110110001001001011010000010010
00100000111001000000010000001011000100000000000110010000000000000000000000000001101100011001001010000
01000011101000000001000100010101011001010000011000011011000000000011001100000100001000110010100000000
00010100010100001001100010011100011100010000000000101000010101000000100110100100000000001010011000000
10000000010110100100000100001100010001100100100110101001101001001101000011010000001000101000000001000
00010000100010111000000011010000000000000010100001001001001110001000001001000011000001010001001111100
11010000001000000000000000000000000101100000100000000000000000010110000100000000000010100000000001100
11100000100000110000010000100000001000100000100000000011101101000000101000110111101001100000100000110
00101100100101101000001000100100000110100110000000010000110101001000000100110001011110000000001001100
00101000010101000001000100010100010000000010100000110000000010001000110000010000100100011001100000010
00000011101010010010001010101010010001011010000100000010000110010000001000101000000111110000110100000
10000000101000011101101111000000110101100100000000000001010010011111000010100101010001100110010011000
00100000000000011010100111010000000010010100001001101001111000101010111011100001011000111011001000000
10010000001000010000001010001100001011001000101000001000000110001000101100010100100001000001000100001
11011000000000000001100100101000000000000011011101010001000000100010000100000100010010010000011010101
01000010000000101101100000000101101000011000110010000111100010010000000010101000101001100111000010001
00000001000011000100010000010001100011001100000000001000111110000110111000100010001000000101000000100
11010000000000100001001000010011000001000101000111000111110010000000100000000010101001011000001000000
01001011110111011001000100010000111000100000010101010000001000001001110000001001000000000111010001100
00000001000010000001110000101100000001100100101010100110010100100001000000100100101001000011111011100
11000100000000001010000000001110000000101101100001000001000101001001001001000110101110000100101010000
01100010100101100010000001010010000110000000000000010010001111001000100000001000000000010010001101001
01000010101100010100100101000100101100000101000110001010001101110000000101101011000000000101000000100
01000101010000000000001100000010111001000100100000100101010000001110101000000010000010011010101101010
10001000101100101000000101001000001000100000000011101000100000000101011100000010000000101000000111011
00010010000010001000110001000010000001000000001101000011010000000101001001001000000110011100001110100
10010011001000011001000000011000010010010100111000010100011010000011101001100101000110100001000000000
00001001100101001011100110011011011010100000010000000100000010100100000011001011010000001010000001010
00000000010100101000101100010010000000010000110001010000100010011110001011000000100001011010010001010
00110000100101011000100001000010100001100100110100000010000000000100000001010001101000000000110001100
00000000000010101000000000101000100110000001010000100100010100000001001000100101001010110010000111000
01100010000010000000110000010010000001100010001100100001000000010101001110010110101010100000000001110
01110000010000000000000000011100010101100000101011001000000001010001100000000011011110000101000000000
11101011101001111100000010101001100000000000100110001000011000000001010010000000010100001000000101110
01000010000000101000000001000000000001010001001000001100000011011001010001000100001101010100110010001
10000011001000010011000001000000000100001100001101000000100000000000001011000000101101110010010000000
00011000000011010000011000101100001000000000001000011001111101000010100001000101000101001000000100100
00100010100101100101010100100010011101100000010101000110000010100000110011000000000001010011000010011
00111100010101010100100110000101000000000101100000011001101101101110011000100000001101100000000000010
10001010000001101000000111011000100111000000000000001001100000000000010000001000100100001110000010011
00001111100000010011101000100000110010001000011010101101010000111110100110000100010010000001110100100
01100000001011000101110110100111000101100000111110010010011000000000001110000000010000001001000000000
01101100011001001000001100000110001010000000100100001100000010010000101001111100101100000001110001100
00000100100101100100000100000001010000111010001000010000111101000100110100001010101000101001100010101
01001011000001100000010101100000001000001100000010010100000001011001001000001001100010010001000000000
01000010000011100011000000100010101000000001010100010000011001000000000000000000001000001000000001010
00011010011000000100100100000100000100000101001000001100100001100011110001100010101010000000000100001
10000010100001011001101001000010111111100000000010000000010010111010101000000001000110000000101001010
10101000000001001100101100010000011100100100010011100001001000010000000000100001100111000110000010000
01010010000010000010100001001001110000000001000101000000000000000010000000000000001001000000010001110
01101000111000110001000010000000100000001000010010010000100000100001010100000000111010110000010000110
00101000100001100000000000001010101001010100110000000010010110001001010000010100001101100000010100000
11000001100001101000111001001100110111000000010110010001010001101000010000000100010001110010010000000
10010001010010010101000010100010100100011000100100011000000010000000100010110011000000000100011100000
00000100001010100011000010000000000110001001001000110001000100000000010100011000000010100010000010011
01101001001010011010010011001000010010010101001101100000100011001010011010000000001100100000001011100
00010100011000000001001001000000000000010001000111101000000100001000101010000001010101000100000000100
00001100110000100000000001001000100000010000111100000100110001000000010001000000000010010100000011010
00010010001100000000110000000001000101110100000000001000000110000001000001001000000000000000100000001
01010101000000010011000000000000001010001000001001010100000010000001001000000000011110001000000001100
