11000001111001000001000000011100000100000001001010100000110001100101010010110110001000000000001100000
00011110001110000000000010000101101000100000000101000001010000100000000011110000001100010000000000000
10000010000100000000001011000100100011000000000010000000000000001010011100010100001000001000000110110
10110100100100100000000001000101010100000100111001001000101000001000001100000000000001011001001011011
10101000011100010111010000101000010011000000100000010000000010100111000001000000000001000100100010110
01000001001000011000010100000100010101010000010000000000110010100100000001000001101101111000000000011
11011000001001000010000100100010100011100100000101001100000000100101110010010111000110000000101000000
10100100001001110010100000000001111010001111000001011010100100000010001100000000000110001100000100010
00000100110011100100010000001000000100000001010001001000000001101010101001000011000101010100110000010
00000010000000000110000000001001000001110100000110000000000000010001010000010100011001110010001000100
00000000100001000011100100001110000001001000010100110000110010110011010001010110001011000000101010001
01000000000010100001010011001001000000100001100000000001001000000000000100100000110100001000100000001
01011000000110110000000111001010001000000101000011000000000110100000000001000000000010000101000011001
00100000000000000100100010001000000000100010100011110100000000010010110001110011000010000000101111011
10100000000100000000010100000010000010000000000000100000001000111010001001011101010001110001011101100
01100010000110010001110110000000000000000101100110010001010010111100000001100010100100100011001000000
10001000100101001100100101100000010101100001010100100010100101101001000100010010000001000000000011001
00000010000000110100010000100100100101000000011000010000010000001100000000001100010100010110001010001
01100001100011101010100010001100001110000101000010001001100101011000001010100000010100100000110100000
00000000000000000000011000111000100101000010001010000001011000110001010001110000100000000110010011011
11100110110010100010100100110001000100100010100001100001100100000000101101100010101010001000010011000
10000000000000001000011000100000001000001000010011001000100001000100000000000010000100010000000001001
00010000100011100001000000010010000000001110011000011010001010000100000101100001100000100001100110100
00000000000001001000001011000000100110101100010000100011010000100100001110110000000000000000100010100
00000000001001100010011000000000110000100000100100010001000001010011011000001001000100110100000011000
00010010100011010100000000100000110000010001000001100110010000000100000010100111100101000000011000101
00001010000011000110000100100011000110000001011001000000010100000100000000000101101010000000101001010
00001100111001101100000000000100000101000100000010100100010111000110000011001000010100001010100010100
00001000110110000000011000000001010000000010101000100000001000000000000010100110100100100110001010001
01000011010000100100000010010010100000111010101110001110100000110101000010110000000101001000000010011
00000011000000110110000010010000000010001000010011010000000110101010000000000010000001101100100000000
10000110100000001000001001101000100100100110010001000010000011100101101011000011001000100011000101001
10110000000000010000000001000011010111001101100100100001100110011000000110100001110000110100000000000
00100011100100001001100100010111100000100101001101000010001000110000010010000111011100010000001100111
10011010010010101111000001000001100110010010110010000100100000000001110100000110000001000000000001000
01001100000000001100001000001000000010000101100100001011010000100110000011000100110001001101000011000
00010110010010000000011010001100100000100101010000000000100010010011000000011100101110001001000000001
00000010010000000000010100110001001000010000100001001000101101101000101000001010010110101000000001011
01001000100000001010000010100000001010100100000001010000001010011111000010000000001000011010010100000
00000001100101000110100000000000000100100000000000010001100001100010100000011001000010000001101101010
00001001000110010000010000000100010010000110010101000000000011001010000111001111010010000001100001001
11100001000000111110000001000000111000010000000010010010000000110000100001100110000110011111000101000
00010010000011001011100100000001000100000101101000000101010100000110100101100111101111000000010010001
00100100100111100010100000001111000010010001100000101001010010000000000100011000100010000000101111000
00000100000000000000010000000001001010100011001100001010011101110010000000000010000001000010100001010
00001000010000000010000000010011001001010000001110000010101100001000000000100000111000100100010101010
01001011011110010000001000111000100001000001000100100111001100010110001000001100100010011100000000010
00000111000001011100000000001000110001001000100011001111010000100100000000001000110110011000000001100
01100000110110000110101100001010000010000100000000010010000000100000001111110101010000001000010010011
11001000011100000000001001100100101000001010110000100000000001000101000100001000001000101001100101100
00110100000000110000110000101110110000010010010100000000010000011000000010000000000010000001011100110
10100100000110111111001000000001011110000100101100010100000100011010011011000101000101111000100101000
10100101000000011010000000100110100000010111000000001100100001000001100000000001000010011010101000000
00000100010000100010000010110111101000101001001000000000100100101000010101100100101000010100001000111
01100000010001110000000010000000100100001000000111010010001001000000010011000000001000101000010001011
00100100001000100001001000001000010000000000010001110111011010011000000110011010010010000001111000101
11011000100010001001010100010000000100010000100010001001000000001001010010001010100010100011000100010
00000001010000101000111000001010000000001001010001001001100011101011000000001010001010001001011100100
01001011000001000001101000101000010010010100101000010000100000111000111111000111000000100000001000000
01110100000001010000001101000100000110111000000001110000000100100100001001111100100010000000010010000
10011000000000011001000000100101010000010110110000000000000001100100000001001001100000101010101000101
10010010100001000011100000000110000001001010010110000000011111011000000000100000001010101000011111010
00000001010000000011000000110111000010100111000001000010000000000111101000000100101101011010111001010
01010101011000011101000100001010001000001010001000000000101100101001000100001010100100000000001000111
01000000100000100000011011011000110011000000001011001011001000000001000000000100100100000000000100110
11101101100100001000000110000100100000000000111110000100001000000000000110000000101011100111110100100
01001010100100001000000100001101001100100000101110000010010010000000011000110000001000101011001000101
10000001010110010010000001010100110000100010100100010000100001000001000000001101000010010001100100010
00111101000000000100000010010010101000111000000100100100110010010010000000000000101110001000110000100
10010000011100110010101000000000011111011000001000000011000101010110010000000111000000000011001000110
00001100000000011100010100011100010010001010000100010101000010000001010100000100000011101010000000000
00101010000001000000000000101000001010001000101000000100000110010000110000010001010110100111000000100
01001010001010010000001100000110000001001100011000000011000010000010001000001000000100010000001011001
10001000011010010000110000000011010001000000000000000000010000010101000000001010000010011000001000001
00110000111000100000100001101000000000110101001000000100000101000100100000000000100001100110000000011
00011100010101001000101110011000100010010000001000110000000000010101011100000010000100000110000100000
11010100000110001001000000010000010111000000100100010100100001000010000000000100010001000100010111010
00110010010100011010101101001011011001100101111010001110000000100011000001011011110101110101001110010
10000010000001000000000101001100010100000101010000100001001110100110000010111110100000000000010000001
10001100001010000000100010101001100001000010101010000101011100101001010000000000011111000110110010001
00000110000000000110000001000000010000010010001000001010000100011000100001001000000000000000111001011
00000110010101010011011001001000100000011100000010001010000111000110100000010101100010010101001001001
00100100010000100100000100011011100100000001110100001011000110000100000010100100011000010100101000110
01100100100001011100001001101000000100100000001100011000111000100000001010010000111000011011111010101
11000101111100000001010100001000010000010000000011000001101000000001000000010000110010110000000110111
00101000000100101001000101100011001000010110010000000000011000110011010000000100100010000100000000111
00011001001010110101001010000000000000110001100101110000101100000010000010001000001000010010011000100
01010000010001010010010110001001101001011010000000100001100000101001011001000000011110001110000000100
00100011000010000100000000000000000010010000110100100100000000001100100010001100000101001000001000010
10000000000010010000000100001000100000100101001010000010000010100010110110110100010110100000000100010
00000100000010000001010000101000001000010100101100001010000000001011011001000001011010111110100101010
11010100000001000000110010000101000001011000011000011010010001001000100111010010000000000010111000110
00111000110110000000000000100000000000000001000010010000110100010100110010001000010000101001110000001
00000110001100010000010011011111001010001100010000000001110011000010100000010010001010101110000001000
10100110001000000110110111100000111101010010111001000000000010101100000010001100000000100100000010010
00110101001100010000011000011000000010101101011000000010000001111011110100000100100000000111000010000
01001010000001100110010001001000000000010100000000000110000100000001010000000000000011100011010001100
11000000000011111010001111001000000111110101000110000011010000010000000000001100010100100000101001010
00100010000001110000100001011000110011100010001000010110101001100010110000001011000111101011100001000
01101001000000100110001110100110010000111010110010000110000001101101010001001010100010101001100101101
10101010011011000000001000001000000100101000001000011001011000000000000100010110000000001011000000001
