01000100100001000111001000010001010101011001000101111001000110100100000000000010100000001001100000000
00001111110100110011010000000000000000001000001000000100100010000000101000011001100000000010101010010
00000010100010010001000000000101110001001100000000001010000000000001100110000000000110000100110110101
00001010000000000010011101000111000001010110100100000011011100000010110001010011100000001000100010111
00111110000000000100001000000000001001001010000001010000000000010000111001100001111100000011000011000
00010010010110100001000001000101000100000010011010001000101110001101010000000001100000000101010010000
00110100000000100110010111000010101010010101001100001000000111100101101110010000101100011111101100000
01000000000000000001000000000001000000101010011011010000110100001100101010101100010000101111000000000
01010010100001100100001110101000000011001110100010000101000010000000011100000100101110000101000001001
00010100000000110010000100000001001100010000111100001000000101011011010000100000110001000000100110101
01000101110100001001001000001000001011011101110000101100110101000010100100000010000001101011101011010
00011000001000000011001000100001100110101000000010100100100001010000001100000001001111100110011000000
00011000010010100010000110000100000001001010010000000110010010000010100011001010000001100110000000111
00000000000000100000010111000000110000001101000010000011101010111000100000000100100110001110001010000
01000100000101000101010000000001000000000100001111110000110010110001001101110011110100000000000010000
00111100001000100100000001000110001100010100000000000001000100100010111001001000010001000001000110100
01000110011100000000011100100000110010000111001000001110110000101000001010000100000111110000000100010
01100000000010101000000100000100011011001101000000000011001001000000111010010001001000100010011000010
00100001100110011101000101000001011101100001000111000000110000100010100100100100000000100111100001010
11001100001010011000010010100000100100001000000000011100000010000000101010101100001000100001000011000
01000000000000110000100101000101000000100011000010000101011100001110010100000000100100000010010110101
01000000100010001010101101110101000110101000100000001101100101100010000000010101001000101101010101010
00000010000000100001001010001011001000000001000000100000010100001110001100011001010011000000000011001
00000000010010010111010001100100000000000001001100000000000110100000110001100000010000000000110010000
00010100001010110010101001001010010100000100110001111000010111101001100001001011010000100000101000011
11010011010000100010111110001001001100000000100100000110010001010000010111101110111000000000010011100
00101000010001010100001001011011000011001001000100101100100100000101000000100011000001001000010010001
10000000001000000000001000011010000010001000001000101000100000001101000100111110101010000001000000001
00000101000000000000001110010110001010001100110010001101000110100000000000010100000110011100011000100
01001100011000101000000000100001010000010001000100010101110000010111000000000001100000001000000101100
00000100000101000000010001010011000011001000010001100001100010000001100000011011000101000000010111000
00000010000000100101000100001101101001010011110000010001010101110101100000000110000110100011010010100
01000101010101001000001100001010000010101000001000100100000000010101100000100001001010010000000100000
00010010000000110111010001000010001101000000010100100100011110100000110000111010010110000000000011101
00001010111100010000000001100010111001100011010001100010001001001101001000100000000010010001111000000
10001010110000000001101000000100000010011011100000100010001000010011100010000110000100111000000100000
01000110001000000100000100000000100100111000101000000101110100100111110000010000010000000011100110010
00000110000001000000110111010000110111010001000011010100100000110100100100000110010100101011100110000
00000100000100101100010101001110010000000000000000101000000000100111000010000001000001000100001000100
00000110000001010000000100100110011000010000010111110010000001000100001001101000100000000101010000000
11000100000000101000000000101001000011010001101100100000101111010101110000000100100000000010110000101
00001011000111110101100000000010010000001000010000010001010111000000001101000011100010000010000010001
00100011001100100101001010001111011111100010010000101010100001011000000000000000100010100100000011101
10010000000000000001001010010000000000111011000100100000000010001001101000001011010000000001101000000
01000001011101000010101110010101000111000100000010000000000000100000000110001001000001000110001000010
00010110000010000001000100000010000100000001000010001000001010110010000101000000000001011001010000000
01000100000000001001110001100100100100000100000000100010000101000101000000000001010011011001000000100
01010011010100011000001000000110010000000000000010000001000010100000001001100010000100101010011000000
00000011000000000010100001100001000000010000011011000000100000000000000100000100001101111000000010100
10100010100001100000000100101010000011000010100000000111110010001000000001001000010011000001000001000
00011000000010010000000010010100000001110101101000000010001010000000000000110000100100010100000000010
00000010000000010000110000000000000101010001010111000000100111000000000000000001000010001000100100010
00001101101100100000000000000101000110001010101101000001101000001001010000111010001010001100100000001
00001001100000000001101101001101010010001000000000100000000101000000100001000100011000001100100000101
00000110000010001001010000000000000100010001110000001001110000101011000000100001000110010000010010111
10100001001000001110011010100100100010010000100001110000000000001110010000010000000000010110010100000
01100110100000011000000010100010100010000010001111110001111000110010001000001010000010010111100000110
00000001000011000100000101000000001101000000000000001000010010010010100001000000011101010000000111111
00100111110000100000010000000010000000010000000000100110101101011110000101000001001010000010001000000
11100011100000000010010110011000000010011000001111000001000110010100011000000101110000000101001100010
00101110000100110011001100000100110000000100001010010000000011101000000110101100010000000010000010101
11100100000001001011000001011011010110010100100010010010100110000001000100001000010100001010100000100
00000000100000000000000010000010000100000100001000001100010011100000000000010001000000101001000111100
01100001110000011100001000010000100001100010101010000101111100001110101100001110011001000000000100011
00101111000101000000101001001001000010101000101010101000000001100000001100001001000111000101010000000
01001000010010001110100010010000001010001011110011100011111000100001100000101000101011001110000100010
10000010100001000010001100100110001100000010101010110010100110000001010001000111001010000000011100011
00001000000001000000110111000100010010100110100100000111110001011101111001101000010001010010100010000
00100001001000111000000000001010000000101111000010000110001010000000100001001000001100001111000001000
10000001111000010100001000010001101011000101000010010101000000000010110011000000100000000010110000000
01100010000100000100010000100101100101010100001000110111011101101010010011000100000000010000111101001
01101001011000100111010001101000000010100000011000100000000100000011000000000101001001010000001001100
00100100000111000000000000000000000000000000000100110010011011100000001110011111110000000100110100101
01001000000000010010110010010000000100100011100001101001010010001001100100011000000001100000001001100
10000100101000110000001001100001010001001100110011001001000000000101101011011011111000000010000000111
01110000101000111110001000010100000001101100101000000010001000000000000100100010000010000111000001011
00001111101010001100000000100101000011110000000000010101011000000100100010010001101010000111001000000
00000010000001000010001000001010000001100000001010100000100101010000100001100100001000000000000010000
11010001100011001000111010000010000000001001000001110110001101001010000001010100100000001110010010010
10000000001100011000000011000000010110110000110100000110100100000100000101010000011001000000000110000
00000110010000011000110000100001000110100010111001010100010000000000000011000010000100100011010000001
01010000000100000100010010110000000100000001000100000010000010000001101100100101001000001000100010100
11001000101100100000000100000000000111100001111001100110011000011011010000000101001011000000010000000
00000011001100010000001000000000000000001110100010011110000010010000101010001001010101001100111001101
00000110001010001010000001100100000110010010000000011000000001000011110011010100100001001001000010100
00000000111100001000001000000001011110010110000000100010000001100001100011100000000100011010001000010
00011000010101100010110001010001110110001011100110000000100000110001010000100100001001001110000000000
00101100000010010000001110111010010100100001010000000010100110000100100000001000001000101001000101100
00100001100010001010001101000100001001111010011000001010100101101000010000011010010100101010000001110
11000000011001000010011110001110100111000001101100001000110000010011010000010110000111000000000100001
01000000111110100100001010011111100000100101001010101110000100000010111111000010001000000100000100111
11000010000110001000001100000110010001011000001000010001011010101100000010000110110000000010000001000
11100000000100000001111000000001100010010101010000001100100011000010110000110000100000010010000111001
01111110100000001010110000000100101010000101000000110100100000100110110110000000000000000110100001001
00010101000011110100100100100100000100000000010100000011000010000011010000010000001001000010001100000
10000000001000001000000000011010000001100000100010000000010011100110000010100000011000100010001101001
00000010001101111110000111011011000000000000110110000001010010101000010011000010010000011010100000000
10001010010000000100010110010010101101001100010000010000000000001011011001011010100101010001100110000
01100000001000000000000000011000001100000101000000000100101110010000001000000000000000000110100000001
10011010000010100000110000100000101100000000011111101001000100100010110000000000000010000011011010010
00001100001000001100000000100100100001010100101100110000000110001101100001110001010100000100000000001
