00100000001000001011000000010001000010001011001000011101010001001100100101010000100001001101000100000
00010010000001011010100010000010011001000001001111000011100110000000001001100000010100001010101000100
10000000010100001001000000000010000000100000010000000010010001111000010010011000100111001000010100000
00110001110110100100010100010000001001100000001000101011100010111000011000000101010001010001100100010
00001001100010001001010000000011100010001000001001000100010100001000000001000010000000110000100000000
10000111001000100001011100001110110110100000100000000000000000000010000000000110000011110000000001001
00001001110000011010000100010001100001010101010001011010100100000000000000001010010101011110100010110
01000000110001000110100000010001000000011000100010100000000100100000110000001010101100010111000000000
00000010010110000001011000000001110011000000101110100010001110110000000010010000010000011000100000000
10011000010001000100011000000100010000110000011001111000001000100000001000000010101000010000110101001
10100000000101010000000001000000100110000000000100110001000010101010001100001000000101100001001110000
10010000001001100000111010000000001000111101000100010000100011000000100000001111010100010000000010100
01101000010001000000010000111010110110001000101000000000110000100000010000010010001110000101110000000
01110001001000100000010101000000100000001000001000001000101011001100000111001001000000000010000001001
00000001110010000000100110010110110000010000001101001010001011010000100101000001001011100101000000001
00001101000000100100100000111001000110100011000010010001001100000000110001100010010101000000111111100
00000010011000001000000010100010000001100100010100001000110010010010010000000001110010000000100010110
11100011000000111100111110000100000000110000000110000001100000000001011000001100000100000010010000011
01000011000100000001011001010000011000000000101010010011000100000100010100001010000000000001000000000
01101100011000101010110010000110100000000110000111010001011001110001000000000101001100100001001100010
10000000011000000010010000000100000111000100000000110010000000001110001100001000010001000000100000000
00000010001111010010100110100111100000000000000000001100100001000100010001000010110001000000100000101
10010001000100001000000111000010011100000110001000010100000100010100010000000001000001000000100000001
01000001010000011100000001100000010010000000010001110000010000110000101001000110001000000000000010011
00100101100000001000100011101101000010000011001100110100101000000000011010000100000101001000011000111
00000101100000000000010001100000101000111110000010001100010001100000111010111001000100000000101000001
00111010000010100100000010011101000010010101110010000010011001011100010000001001001011010001000000110
00011011000100100010000000100001100000110101000000010011000000000100000000010000000100011010001101100
00100000101000000111000000111000000001000000000001000011100011110010000010110100001100100010001101000
01001100101100001000111001100001000010011011110010001101000000001000010000000000000001001000010000101
01010000000010100011010010000000010100001000001011001000110001000010000000000001000010100000000010101
00001000100000000000110000000001010000000100000000111000000101110000010010101100000000001001100001110
01000100000000000010101001000000100011000101100000101100000010010000000001001010010100000000101010011
00110000111100100100000110010000001000001000010010100000101000000001011110100101000010001001000000001
10011110110110100000110001001000100000000101000111000001000000000110010101011100101000110000000001001
00000000001001000011010000001000000000000000001001000100001000001001000000100110001100101100100000100
00100011000100011001000000000000000001000010100010100000011101001000001110000010101011101110110001100
11010001000000000011101000010010001010000100000000000000100000000000001000110000100110001010110000111
10010001001010110001000000000000010010010000101001001010001110011100001100010000110000010110001100110
00010011010000100001011000010100000000000011011010000000010011110100000000000000000000000001001101010
00110101000011001000000100100000000010100100100000000100010000011000000000000000101101000011101110000
01111001000010011000000100010001001010110010111000000010110110100010011100001101110101010001011011000
10000001010011001010000110001100001100010010011010001101000100111000000001100101000000001100001010001
01000000100000000011001101100000100001001101011000000010000101011000000101101000001000000010100110011
10110100000101000011011000111100001000001000000010000000000011001010100010001000000101100001010001000
10000010001110000101001011010100001010010000001001100101000100000101100011000100110101101100010111000
00000001000101001000000110010011100011001100001001011100001000110101010100000010000110001000100010010
01000011100000000001000110000000000000010001001110101101100000000101110000010000100011010010000010001
01110100000000000010001000001011001100000010010110000000010010101001101001100010001100100001101111011
01000010110000000100100000010001001001010000000000000100010001000111000001011010000000101100000111010
10000101000110000000010100100110000001000000000011000010000001000001100100011000110101000000000010000
10100110100000011100010001100001000000000100001001000000100100100101101000000011010111101010000100000
00000100000001000000000010000011100111011101000010010000100000100101110110001001010010000000000000000
10100010000110001100000000001000000010000110001010010010000010001000000100001100000110100100001010011
10000001000000000010100000001100001010100110000000011000110001101000101010101011100000000000001100001
01000110010010010001000000100110000100000100011011111010000000100000101001001100011100100001000000000
00011010101101010000011010000000010100111100001100110110000000100000010100110010010000001000010000010
01110110001011001010001010010000000010000010100110000100100100000100011000110010000000001100000000111
00010010110000110010010000100010000010000100100001011001100010010000010001000111001000010110100101000
10001100101100010000010001100000010001011011001110001010100000101000011000010001100100101000000100000
00000000000011110001010110010000000000000000001100100000000010011100010000000000000101101001010010000
01000100100010011000000110100001000010101011000010011000000010001101100011000000000001000110000001111
11000100001010000110010000110010000010100001110000110010000100010000100100001001011110100011100100010
00101111101101110110011100000100001110001001001100111011100010110100001100000100100000100000010001010
00110011010110001011101001000010100000000000000000100000000010111000101000000010100110110000010001101
10010000101010000001100000010010011111100110100000000100101000000010000001111011100100010100000010000
00101100001001001000001110100010000010000000110100000000010010010000110011010000000100100000110000001
10010101010000101001010101100110000001100000100110000000010000000100101000100010100010101011011110010
11110001101010011010000010110001101100001000100101000001000000001000010000100110000100100000000000000
10000000100000000011010001110110001010101000101001010000011100010001101001011000000001110000001100100
00000000000000100000110101011001000000110010111000100110111001001110000000011010001100000000010110001
00100000000000101100010010000001010000100001010001000001101010000001100110000100110010100001010000001
01001001100011011001110000010001110100010111000000000001000001101000111010010000010000100000000100110
00011100100001110110000110010000000111100000000110000010001101100000000011001101100000000001101000100
01000000010101000100100000011010010100000100100001001101010000101110100001110000001000101000011011101
01101000110100000010011000010100000000000010000001010000011110010001100000001001010000100000000111000
01100101000000100000010001100001000001010001000001100010001100010000100001000000001011000000100000100
10001100010001011000110000100011000000010100100000111000000000100000010100000100010100000110100011000
00010000011000000001010101000100101110000011011000000000000101110000010010010000010100010000010000011
10010000011100000001110100010100001000011000001010110010010000000001100010101011001010100000001000011
00011101000101000011001010010000010001010110010100010101100000000000000100100000010011000111010100000
01010010000000101000110000001000001111001000010100000100000010000011100000101011010000110010100100000
11000000000110100101000000001000010001000000010010010111000000000010100000100000000001000110010000111
00100001100100000000001011001000111000000110100001000101100110000000100000000110010000000011000010000
00100100000000110111000000001100000101101100010000000010100000100101101000110000100010001001110000011
10101011011010001000010011011001111010011110010110101011100001000000000101000010000101001010110000001
01011000001000100110000000100000001110110100100000100000000000100001001000000010000010000101001011100
10000000001101000110101110000000110000000100010000010000100000100001000100010000000010000011000000110
00100101100111001010000100000010001000110011100000110000000000010100000000000100000000001000000001101
10100010000000000000000100010000111000000001011100011000010010000001011000011100100010000001000011001
00000100001000001101000100011110100000001100110000000001000001010000001110100100000001010001010001010
00101100001001010010110001011100000000100001000110111100001001110001010000110000000010010011010000001
00100000000000101010000000001000000100110101000100011011010100001010100010000010000000000000101101000
10000001000010100010010011001000000000110000110100010110001101000000110010000010100000001001000001000
00100110001110100101100100000110100100000010000001011100000000010000000001001000110000000010000000000
01010001000010010000000001001101001010000001000000000110100110100100000001011101000110010001011000011
00110011001010010101000000001111000000110000000100000001100001000001010000111000000001001110000001000
00110010110100000000000000001000011000100100000011000011001000100111000001000100000011001100101001110
00000000010010001110000001100010000000000101000011100010000110010001000000001100001010101000000100010
10011000110101001001001010111001001010010011100001010000010000100010011000000100000001001010011000100
10011100101000000001000011010101100100000000011000110000010010100000011001000100100100011001100000010
