11000010000000011000010101100111000010001010010101000000011000001110100010000001100110000000000100001
10000000111100001000000000100010000010100101000001000000001100001101010000000001100001100010101100010
00011000000010101001101000000010000110011000010110000000100110001100000010001000011100100101001000001
01000001010101000000000000001101000101100110001000101000001001100000000011000111000001010000010000010
01000000100001000000001000110000000000100110000000000000000010011110000000100000010000000000111100000
00001011100011000001000100100000100000010100001010001001010000000001100001110000001010001000111110000
01001100000101010100001000000000010011010011000100000110101101000000001010010101011001101101000010000
01010110000010100001010000000111000111010000100000010001001000011000100000100010001000000001001000000
00100000100100011000010001000000000100010000000000100100110100001100000101001001110110000000000110000
00100001001001100001000010111110000010110100001000000000010000000111110011000000101010010110001001010
10011001111100001001000000001001100100100010100010000000011001001100010000000000011100101011110010000
00001110001000000100011001111100000000010100001111100000101000001100110100000110001000111000000100011
00000000001010100011000000100000110000011000011000000000000010101010000000000010010100000000110000001
10011010010000000101000000100000100100010101000001001000011100000000010000000001010010001000011010000
00010000000110100000000100010100111100001001000000010010000000001111000000000010000011000100000010100
00101110000001010000000001010110010111000110100000011001010001000011000000001000110000101000000000100
11000101111000000000001100010000000000001010001010000000000000011000000000010001000100110101001010011
00100000001001001000000011000000011011000011110000101000010000001100001000100001000010001001000010110
01110111010001001100000100010000000100010010000001000000001011000101110111001000101001000110100100011
01011001000000000001010001100110001010001000110000010011000000001000010010100100000100100000010001001
00011000100000000001000000000011001000000000110000010010101000000100100010111010100000000000101000000
00001011110100110010001000010010000010000000000100001010000000110100000000011100001010100100011100100
00000110101001100010110000000001001110001000000011010001001010100010101000100100100000001010010000001
00100000000000011000000001001000010110010001000100001001000000110001010110000001000001000000100011010
01000001000110000000001000111001010111101100000010100011001000000100001000001101001100010100001110000
00010001001001001010010100100000101110100101000100011110100111100001001000111000010000111101110010100
10001000000010100000001001110011000100100000001000011000001010001101010110100000000000010110010100000
00000000001001011000001001111001000000000000000000000100100000000011011100000000101110010100010100011
00110000000001010101000000001001000010000001100101100000001000100101101100101000001000110001001110001
00000000000100011101001100000000010001011010000000000100111100000000100001000000000010100000000000001
01101000001001000110001000001000100000001010101000111010100001001010000010100010101101000100001000010
00100001100010000000001000000101011001000110000011000100001010001001010000010000001000000000110100100
00000100001001011000101000101011000001001001001110000001110001000010000010001101011010000000000000000
00000110000100100010011101010101000101001000100110100010010000000000000100010101000001011000000010000
00000011000000000110010100011000000000000000000000011000100000101101001001101000100100010010010100100
01001000001001010110000010100001010000010010100000011010110011000000000110001000100000000001000111000
00001101011000000001110000000000011101001010001010100000101001111011000111000000001000000000001100000
10000000110110000100010001100001110001000111110100001010000000100001000010010000010000000000001000000
01100110000000010001001010000000100000001101100100000000010010001000111000100101110100001000000001100
00100101101001010001100101000010101000000010100101000000010000100100000010000011000010001010100000000
10000110100101000000000100000001010001000000010100000010100010000011010101000000010000100000001010001
10000001010000010111001110110100000110011001000000010001001000010110000000000101010100100000000100101
01010000000001000010001001010011000000001000100000110000010000010000100000010100101001010010111010001
10101100001001001010010100010100110010000000000000100011000000001000110010001001100101101101000101000
01000010000000001001010001100111010001101101100011110001101010001101000101101010000011010010011010000
00101111000101010101000001101010100100010000000000100000000000000010000010000000100000000010000010010
11000001001101010000000001001100110110001110001100010101000011001010111000101110110000010111011000101
01100001010000100000101001100100100101010011111111000001000000000001011000100010101011000111101011100
00000100000010000001000000000000110000100000001001110100010110111000001001001100011000010111011000000
00001100100000000001000000100000010010110001010001010000100100000000000000010000000100001100000001000
00010000010010010000100000110001100110100010100100100000100000010100001000010001010010010000010001000
01001001000000010000011100001000100000000010010101001001110001000010010000100010001000000000100100100
00000001100000101000010001010100000100100000000000000000000000111000110100010110010000110000001100000
01001000000100000001000110011101000100100100100010000000000000010011001110100001100100000000100001000
00000100100010001001100101010000101101001000110000111001010100000000000000000010110000001101000000101
01011110100100111100010000000010110000010010000100100011101001000101000011000101100000100001010000000
00001010000010000001100010100110100000101000001101010100010011000001001000011001000001101001000001011
10110001010001110010001100001000000000000001010110000000111001000100000110000010000000001111001001010
10001001000000000000110011001010100000101100011010010100000001001001100000010000011100010101000000011
01000000011100001110010000000001110100000001000100010000011100010001011000000011101010010100000010010
00000000011110000000010000001000000001100101001010100100000001000100010000000010000101000000001000010
11000000100100110000001010000110000000001010000000001000000110000100001010100010000010001100010000001
10011000010000100011111000000100100000001100011101110000101000001100000010000000000000100101100010000
00100100100110101010010000001100011110111001011010010000000110000001101100000011100101000000010000001
00010010001100101101111101010000011000001000010011010010010001001000100000010001001001000010000000100
00100000000011100010000001001110110000100100000111010010010001101000010000101010110000100000010001000
10001000011100000011001000000101000110001011000001001100010000000011000000011000000000100010000010000
01101000001001001000000100000100000111000000001011001100000100101011000101100110110110101101000010100
00000110000010010000010000010000000000010000100110001010000011100010000001010100000000101110101000010
10100011011100000101000100011000000000001000000010111001000000010111000000000100000100001001011000010
10011001010010001000000000110100001010001000001001100010001000010000010001110010100101000000100001101
11010000011100000011010000000100000000011100100100000111000100000100100100000000000111110010100100010
00110010000100001000000000100110000000000100010011000010111110101001001000011100010000100000000000100
01001101000010101100000000100000000100001000000010001001111101000101000101000000001100000001110001011
01011100101000001000000110101001101010100000010100000000010101101101101001001010000000000100001000100
10000001100100101110000000001000110001000100100010000000010000000100101000000000000011111100000100000
00110100010000111101110000001000100000001011100000001101000100001000001111000000100100000001100000001
01010000001100101000100000000000110000000010000000000001100111000000000010001000000000010011000011000
01000000001010001101010010010100000000000000100000100000000010000110010100010001000000000000100000110
01000011010000000010000101011010111101100000000111100010110000000000000001011011010100101000010101000
00000001000000110001000110000111001100001010000000001010110000111000110010001000100000100010010000000
00101010010010100010000100100001000011110000000111001000100001000001010100000111100010010101100011000
11000110110000100110000000100100011000101110001010100001101011001101100010000100010000110100010010001
01100101000000001110100000100010100000100010100000000001000000011000101001010110100100001111001010100
00010001110000100011000110100100110001000000000001000010000010000100000010010000100011100000100000000
00010000000110000100001000011001010110000010001001110001000001000000010000111100001101001100011100000
10000000100100010110011110000000000100010000000010101000100010010110100001000001010010011001010000100
00011000010101001000010000101010010100000001000001000011010001000010000110010001001100000100100100000
01110000100110000000000000000010010000000001010100011001000010001000010100111000010010101001010100110
01000011011000000100100010110101000000010110010000000010111011100000001001101000001001000000000110110
10010000100010100010010101011000110011010101100011100001010111000100000110111000000001000010100001000
00110100001100000000100000100001001000011000110011000000001011010100010001000100100000011010000001000
10001000100000001000010000010110100100010000101100100000100100111100001010111010110101000101000000010
11000001010100100010000000001100010010000101000101010010100001010111000001000111001000001011110000001
00000101001001000010000010000000001000100000000010000111010000000010000000001110110001000000110100100
11100100001100100000000001001111001100011111111000111010001000100010000010001110001000110110010010000
00000101001100000001000001000001010011101010111011111001110000010011000000111000001000111000010000100
01100100000101001010000101001001000010101101001000000000000001010000000100000000000000101100110001111
00100110111010000010000001100001101001001010100000101001100100000000010000000010100000000001010110010
10100011111001000000110001010001011000111101001000000101010000010100101000010001000000001110010000000
00010100100000100001000001001000000000010000110000000010000001110010100001101110000000000000100000000
