00001100000111100010101110110010110000110101000000100001001100001010000101100100010000010010011111000
10110010110100110000101001100100000001001100001000001010000000000101010100100001000010101001010011001
01010110000010110000111111000000000010000101010001001000000001000101010010000100000000001111010000001
10000100010000010101000000010010001001010001001111001000100110101000000010000100100001001010000000010
11010000100000001000000010000000011000001100100010000101010100000000000001000000001001110000100010000
00011011000000110100000010011010100001110000000010000000000110001100100000000000101000101010001010100
11000111001110010000000000000000100010000000010010000000000000001100001001010111011101100001011000000
10000000011010011010111110000000100000000000010110000100000100000000000110010110111000100010010010000
00011100000010010101000000100001000010100000101010001010000100100110010000000000100000010110010110010
00101000110000100000011100110000100001100100101110100000010001010100000000011011000000010011010000001
01010000000101000110100000101101000000000100011010000101100100000110110000010100001000100100000010000
00010110001110100101110000011010011001000000011001100100000001100000111001101000000000000000011001011
11001011000100001000101011001000011101100000000001101110100000000100000010100010001000010111101000101
00100000000000110000100110000000000101000000100000011001000000100101110010110100001000001010001010111
11001000000110000100000000001010011000000011001000000000011000100010010000110101100010000001000000000
00100010100000010000000000101010001110001001110100000001000101000010111010000101000001010010011010001
00010100001011011110001101100001011001000000000100010001100001100000010100100011000000000000100000110
10100000000000010010010000010000010110111000100011000000001000000100000000010100111000110100000001100
10100010000000011000100001110100010001001000000101000010100011000001000010001010000011010000000011001
00110010000011010001000001010011001010000101000100010010111000000000010010000110010000100000101000010
00000111001001100000011100000000000011000100001010100000010001010011010011010000000010010000101101100
10000001100000110010100100101100000100010000000010100000101101000001000101000000001011100100010010000
00010000000011000000001000001100000000110111101000110010000010001100001001001000000000100100100000000
11110000001001000100100100111100000000100001101100000000000011100010010101000010000001000010101000101
10000100011110011001001001110110000100001011000010110111011010000010000001000000000011010101000001000
00010100110000000000101011000000100001010100101010100010000001011110111110110011010100100000000101100
01110000000010100000010110011111000011101011100100101001101000001100001000111001001010001000100100100
00100000100000000011000001111000100011000000000000111010010111011000100100010101000100110010000100001
00000000010000000000110000001110001001000010000001100000010110000011010001101101001010110111000011001
10000000010100000000001000100001000010101001000010101101010100100110100010000000011010010000000000011
01000010001011101010100110010100000000110000000100000000000100101011000110100010000100001100010000101
01001000000000010111100000110011000000001000000010111010000100100000100101000101000000000000001101101
11000000100001100010100010100110001000000000010000010000010111011000000110100100110000001110001000010
01010000000000000000100110101010000000100100001000100000010010000100001010000000100010001010101111000
11011001011010001001010010010010001000000000010100000100100110000000000000010000001000010100000111000
01000010001010001001100011101010101110010000101011010000100010100110011000100010101000000001000010000
00010110010001000101000010000101101000001000000000010011001000100000011001000000000011110100010000011
10001001100000001010110011000101101011110000010000100010001000010000111000100001001010000000000110100
11100110110100001011010000001000000011101010010000000001000100010000010101011000100100110000001010001
01100000001001100010001000011001000001010010010011000100000001101000100011000110000000010000000011000
10001110101110110001000000011000001100010100000011010000100000010001001000000101100110100101000000010
00110011000001001000000000001001001001111000000001110011001000100010011000110001000000001010001001100
01001000100000001001100000101000000000000000100110010010010100010000110000000001101000000001000010100
10100110110100010101001010010000000000101000001010010010010001000000110100010001110001110101000011011
00000100010001110100100001000000000000010101010001001100010100010000000101000100000100000001000100000
00101000100000000101010000000110000101110001010010111011010000000000101000100000011101100011000110010
00010001010000000000000101000000100000000001010001100111100000100001100010010001110010111100110100100
00000100000011001011000000010110000100011001010100000000010100000100000000000010000011001000000000100
00000000000000010000001100011010101000110100101010001101001000001001000000001000011001001100000010010
00000000010000000000010100000011001100010011000000101000100001010101110001000111000001011010000010110
00000001111110001000000001100010101000000000000010000010100001101100001001001100000100101010100100001
10000001001100000010100100101010100100100101010000000010100100000010000010000001000000000001000010010
00100010000100000000000010001010101000001010000010010000110100100000011110001000001000000100100100000
10001010100011101011000100001001011111000100010000010100011000101001010000000010100010100011100000011
10010001100110100010100100100101010000000000001000110000001001000001000101111001100011000000010100010
00001000100001000100010010000011000101010000000001000000000101010000101101000100100011110000000111000
01100011100000000101010110010101101110000001000001101000001000000101011000010001010000011000010001001
00000000100000100110000001000000001100101010100000000001100101001010001000001000000000011011000001100
01000000000000001000000000010000000001010111001000100110011001100011010000011000000000111100010000001
11001100001001001000000100100010000010101110000000011010001101110001010100001000010001000000000000100
01111000000110101000110100010000010000100000110011000000001110000000101010110110010010000010001010010
01111100011000010011010100110011001011100000011010010000000010100100101001101010000000000011000010100
01001111100000110011100000001010000000101000000000000011010101000001110000010001000001110000000011010
00110010100010001000001000010000101000000000001000000010010010001111010101000100010001111100011000000
01111101111100000100100000000001010100001000100011111100000000000110100001001000000100001111100000000
00000001000010000000010110101010101101000110100110010000010011110000000110010011010000100101000010000
00000000001000010100010001001000000001000100010100001100110000111011000110001001100011100010110110011
00000011000100000101110000000010000000000000000000000010000011011110000011100000000010101110110011010
00100110000100101000001000100000001000001001100000000011101110100000010101000011000000000110000000100
00110101101001001011010010010011000000001001100010000001000110000001110100110001010000010001000100001
11000000010011000100100010110101100000010000010001010011010000000101000001001000110110111000010000100
00100000000000010011001100000000001000111111001000001111000000000001110001000110000000100100000000001
10000000101010001000100100001000010000000010011001010010001100101000010000111001001010000010110100100
00100000011000000000100111000010010101011000001011011010000000001010110000111010000000000000100101101
00000100000000101110100101110000000100000010111000000000100100101100001011011101000010000100000001001
00110000000001100101000000010000110101000011000010100100001010010001011001101100010100101011001100100
00010011101010000010011010011000110000100011001000001000010001100000100000111000000001010000011000000
01100010000101100010000010000000001000000101010010010100000000010000000011110001010110011010010010001
00100100111000001111000000000110100010000000100010110110100000100000010101101101010001100110000000000
00100000000000011010011000100100000101000001001100010110100000000010000110010010000000010100100000100
00001000000000010100110000000100001001000000001010000000110001000000000101000001010001110001000000011
10000011000000010010110111011011010001110001000001100101010100010001000010001000000101111000000010011
10110101100000001100000100100000110001010001000000000110010000000001000000100100000000010000010000000
01000000010000001010000101100010010000000100000010000100110101000000011000010100110100010000100000100
00100001001000000100100000001011000000010101010000000010010101100001000000100011101110000000100010000
11000100111111001011010100010001000100000001111000101000010101000100000010000000001000001100010000101
00101110001000010010101010100010110010000001010011000000000000000101000000000100100001010000010011001
00000000001011000010010100000001011000001001000100010000000100010110001110011000100000010000010011000
10100000010110100100001000011000100000000010000000000100000000000000001000110101001000100100110100011
00000000111001000001000001001101100000111010100100000011000011111000000000001001100011000010000101100
10000111001001101011000010110001001111100001100000000000011100000100100010000000100110010001000010000
11011001100101111011000011000001000111000010011000100101000000000000000100000000000101100000000001111
00000000001010100110011010000100010000000001100010011011000011000100010000010000100100101001011001011
00000010000011010000100100100011010001000011111000110011101100100110100000000010111000000000011010100
01000000011010100101111101100000011000100000110000000011010000100100010001000010001000000100000010000
11010111100010001000101000000011100110000101100001000011000000001110110100011001010001001110001000000
00100000010001100000100100100000001001100000010010001101000011000000110010000001000001100101110111000
00000010010111000100000100000000010100110001101001010000001000001001101101000000010000100000100000010
00000010111000001100000000010111110000001001010100101100000000000100011001101101001010010101111100100
00010001001000000000000011100001001101100100001000010000000000000001000000011100101000000000001100001
00010001010011000000010000000011001000000011011001011100110000010010101000000000000000000100010100000
