11100000001001011101000111010000010000100010100001000001000000010100110011110001010101011010100100101
00000110000001000010000001000001001000110010000101111110010001011001111100100000000000001100011011010
01000000001000010100000000000011000100010001010001100000100100000000000100100001001000001110000100000
10000000101100000011100101000000001110110100100100000111001000001010000010101100000110101111000001000
00110011000000000000000101000111000000110000110000000110110000110000000101000000101010101101000111000
00100000111110000100000100000000001110000010000001000000100101001000000000001000000100100000000000001
10000101000000001111010101000110000000001001000000100000001000000001100100110100001000001011001000010
10001000111000001111001111100001000100000110111001000100101010000001011110000000000001100000100000011
00100000101001100111000100010101000000010000000011000010100100001111110000100101010100001010001101010
11001000100101110100000011000000011101111000010000101100000010100100111000000000100101000000001000010
00100000110100000001011111000000100000000001010000100000110001101000000110000001000000010101011001001
01000001010000101011010000010001110001010010010010001000011001000100010010000101100100101100001010100
01000010000010100010100010000000010110001000101010000110110110010100100111000100101100010011010010000
10010010000001111111001010100111010110100100011001001000001000000000000000000100010001011011011010010
01010000000001010101001000000010000110000100000001100000010000010100000000000000001001000000010010001
01101111010001100101010000011000010000110010000010000010110000001100010010000001100000100001000000001
00010000011000000010100010000000000000000010010100000001111010100101100111001100110100101010100010001
00010010100010100011011000001000100000001100100000000010110000110100100000100100100000100000111000001
00001000100000001010110100110001010001000100000000001000010111100000000101110010001101000000001100100
00011000001100000000011011000100011001001000100011010010001000000001000110000100101010111001000011000
10110001111011000000011001000010010000001101000010010010000111001001100100000000000000011000111100010
10001001100100000000100000000100111101100000001000010001000000101010000000000101010010100010010010010
00000000010000110101010001000011100001000000000000000010100000010010011111000010000011010000110001000
00010001001000000000100001010000010100000100010010110101100111000000011000011110111011001001111001100
01000010011000100010001000000110000010100000000010010000010010110001100001000000000001000000110010010
00000101000110000101000100010100101101111000000011001010001000010001010001110001001001000110101000000
01010100000001000000001100100001010000011111000011001000010011010011000010100010010000000010010000000
00101100011100000100100000000101100001001010000000101100001100000011000110000000001000000001000001001
00001001110000000010001000101000000100100000001000000000000100000100000010110011000110010010100000100
00010000110100000100100010000010100110000000000000001001000100101100101000100000000000011001010110111
00000001001000010000110001001100000000001000000000110010000010110010010000001101100010001000011100011
01000001101010000001110010000011000000000011101101000100011010000000000100000100100000000010111000000
11110000000100010001000010010000000001100101000001010010001110001001110000001001110100001001001110001
00000010000000100011010010000001100011000100001000001100001000010000110001010010101000010010101000000
00001000000001100100001101001001010110011100011011000111010100001000000010100000010110110001000100000
00001111011001111011001110100100000001011001010000100011000010000001000011100001100111000100000001000
00000000001010101001010100001100010111110010000010100100100000111111000000000000000100000110100001010
01000000000000010101101000000001010100011000000001000001000000001101001000100010110011100010000111000
10001000000110000100001000001000010001101001000000011000011010000001010111000100100100000001010101001
11010111010000100111000001000010011000001001000000000101100000111001100001001000000000000111000010100
00000101000010000110111110100000111000100000000100100001001000100000010000000001100001000000010100101
01010001011001000110001101001000000011100111000001000000000101000001000110100000000010000100010010110
00010100000010000100100001000000000101000001000100001010000010101010110000001100000111100101000110000
00011000010000000101001010100110001010000111110000001001000010011000000110000110010100110010100000001
00001111001101010011010000100011010001100000011110100000010000000101000000000000101100010011000001000
11000000000000100000101010101010000011101000010010011110000100000001000101000101100010000100010001000
00000000000100000001001010000010000000000000001001000111001011000000010101000010000000100001000100010
10001010000000000100000111010000000100001101000101011010100011101100000000100011001001101000001000001
00010110011100000000011011000001100010000001000100000111000010000100000000010110000011110011011000000
00000100100000000000001110000100000101101000001001000011001010000101101010101001010100100000000000000
01011001110000000001100100011111001001010111010010001010000000011000010100000101000000101110010000101
00010010000110010000101001000001100100001000001011011100000001001000110000000101011000010000011000000
01010000010100101011000001110010000010000001000001011100101000000100000000100000100101000100000000100
11110010001001000001000000000010001010000011101011101010111010001011001000001010000101100000101011000
00011100000100010000011000100100110100011010001001000100001100101110110111000010011001000100100001010
01100000011000100010010000000011010010100001000001010001000101000011010001100101000100010100000110100
00100000100000001000011000000010000000100000000001000001100100010001000001011100001101100000000000100
01110100000100000111000011000101000000000000000010000010000001100001000000001010101010000000010110000
10000000101010001010000101000100100100001000100000001000101001000011000010101100110010011000000011100
00000100100001010010001110100010010000000000001000001110001010111110000100100100010100110100000000100
10101100100011010000010111000001001010000011101000100000111100000100010010101010000001000100010010100
01011001000010000001100000000000001000000100101100010000000001001010110000010111000001010001101001000
00000101001010100000000001101000001100011011010100000111010000100000000000010010000110000000100110110
01110111100000001100100001100000000001000010100001000011011010000001001000000010001000101001100001000
01000100000000001100000010000000100001110101000011100000000100000000000000100000100100010011100101000
10110000110000001100000100010010000101001011000010000010010011110010000011101000100000110000001010001
00110100000101000000101000010011100000100101001000001010011000000011100001001000101100000111110110000
01000000100100101100100101100101000000000000010000010001101010000000010010001000100001000010000000000
11100001010000000000000010001000010000100000001000000000101010100001010000000100100100100110010000110
00110000111001000001000101100000100101000011110000100010000001000110100000000010000010000001001011101
01110000111111000000001100010001000000000001011001101000001010001000001110000010011101010111000000001
10000001100100000000000000000100000010100000001000000100000000010000101110010000100010011000101010100
10100010000011100000001010010010000100000100101011011100010010000000101001100011110100110110011000001
10000100000010001110101010000000000000000000001000001100000000000000100000001000101000000000010100101
00001100100001001100010010000110010010001000010111100001100000010000010011100000001010000001111101001
11100100010110000010010010011000011101000000000000011000001011011001000001000000010100001000011001000
00000100010000111000100000111000000101100010100100000001100111000001000010000010110101001001001001000
11000000001100010110001000000011101111101100110000010001110000010011001000000000011000110000000010100
10000101000000000110111000000000110000000001111010100000000100011000000010100000101000010100110010011
00000010000000110000000001010010000000001000000100001010001100001010110100000100100110000001001010000
00000010000010010110010000010101100000010000000100010111001011001100000000010000000011000001101110101
10000001001000000000001100100010000100010001100100001000010101000000001101001110000100000010000000101
00000110000011000000010001101111011000110001000010011101100100010110010010100010110000011010100101011
11001000000100010110100010100000101001000010011011001000100111000000000000110000001001000010000000100
11000000010000100101000000010011000001000000110001111000100111001000000101000001000000100001000110000
10011001010001001000100010110000110000100000110001000001010001000000000010100000000001000000110001100
01100001100001100100010001101100111000010000011010101001001000010001000001000110100000011101010000001
01001010000100111000010110111001000010001000101010000001001000101000000000100001011010110010101010101
01010000001000011000011100001000100000001000001001100001010000100000010000000011001000001000001100000
00001000101000000000010100010000010010000110000010001000110101000011001000101000000000010111100100000
01100000000000001100011010001000000000001001010110000010000101100000000000111101101011000001001000010
00001000100000100001000001000010001000100100000011010100100000100011111000000110000000000100000010000
00100010100100001000000000011000100100000001001000000011000001000100001000110000111000100100001100000
10100000100111000011010001000001010010010010100011001011001111001110011100000001001000000000001100000
01000010001001001000010001011001010101000000000000000001100001100000111011000000000000000000010001010
10000011010100100011101100000010011010000000110000000111010000000101100101001000110010000010010100000
00000110000010001000010110100100010100000001110000000000010110001100011000101000010010000000001110000
11101100000100101011000001010101010000101010000000011000111100101110010000000001100000110000000010101
00010010000010000101001001010101000100000011011100000001000100001000000100001001110110110101000100110
01110000000100000001000100011111000100000110000101000011000010000000000000101101100100010000100011010
10100110010000111001100111111100011100000001000000000100000110010000000001100111100000000000001100000
