00100000001100001000000110010000000101001000111000010110000011001100000110010000000100010100010010000
10000110001000010100101100001000100000010010101011010000001010000000111110100000001000000000010100110
00010001010000000001011000010000000101010000000010100001010100101100011000010000000001100111011001111
00100000100001001000110011011000000100100000111011010110001100100000100010010101000010001000000000000
00000001000000100000010000110010101010000000101110000010000000001000011001100001000000001100011000000
01010001001100001000001000110000101011100101000100000010011100100000010100000010000000000010000010011
00000010000101110100000000000110000010000100000001101100000000001011101000011001100000000010000000001
00001000000100000001000001101100101110001110100111100000000110000000000000000000010001100000100100010
10001001100010000010000001000001101110001101000000001100001000001001100000001100000001001010100001011
11111001001001001000000100110000001000101000000110000110010010010000000110001010100000000001100000000
00110100111010101000101000010010000001000001000010111000110000100000110010100010000010000100100100010
00010001101000110011000000000100010100000000100000100010100110100001001110101101100111000000000010000
00111000100010100100000010000000001110100010001110110000011000100001111011101100100010100000101110110
10010001000101000111101000000000100001000011000100000000110100001000000100010001001000110010011010001
01100000010110000000001000000101011010100000000101000110000000110011001001010100110000110000101000001
00000001001100010000000100011011000001110000010010010000000000010010001000010100100010110100010010000
11101101010100010010010010010010101100001010001001110000000000010000100010111000010100100000110000001
10011000000100110100000010000000000001110000000100000000011000010110000100000100000100010000000000001
00000011000001000111010001010001100001001011100000000110001110000011000110000000001000010001000100010
00000101100011011101010000001000000100000000001010010000000010000000010000100000010000111000101010101
10100000110000011000000100000010010110110000011000000011000000011101100100010001010010000001000000100
11101001100001100000010011010000001000100101000101111100010000100001100001100001011100100000000001110
10000000010000001000000100111100010000001010000010111100001100001000100010110001010110000000000000010
00000010010000101101001000011110100000101100100110000000000000110001011000001111100000010010010111000
00010000010011000000100010001110000100011001000000001000000011010000110100101010000001100010110111100
01001101100000000010010100100000001100000011110100000010001000000001010010110010101011100001110000000
00000110000100101110111110001001001100001000000000000010000010010101110000000100010000000011000101000
00000001100100001110101100010100000001001000110101001000001001010010001010100011100000100000000000001
10100010010001000000101111000010101000000101010000111010110010001000000110000000000100100000110110011
00010000000011110001000001110110001000011000001010000110000000000101100001000110000111110001111101100
01010000000110110100000010000100000111000010100001000100110000001001101011000111000000000000011100000
00001110001001011000010111000000100000000000000010010100011000001000001001000000001110010101111010100
10000000000000000010100010100000010000110001000000000100000011101010010100010100111001001000100000000
01000001001011000010000000100010001000010000000010000010000110000000000000111000011010011001000001000
10000110101010110001000110110000010000000011000000101011100010001000010111000100001101000010010010100
01101010000011011110000001000111010000000100010010001000101101010000000010101100110100000010000000001
00001000110100101011000000000000010000000100010010001100010110001010001101010011010010001110100000100
00001001110100010000011000010001000000100001001100000001000101100000100000010000011100001010000001010
10110100010010000011101110011000101011100000100000100000010100101001010100111000010000011101101100001
11001000100010010111000000010100011000001011010000011010010000000101000001010010000100001000010110100
00111111000100001000000010000011101000010100000010000111010110011110000100000001110010101000000110100
01010000001001001100010000001010010000000100110101000001010010010100000011000100010010001010101000000
01000110000100000010000000100000010101100100000000100100000000010000000000000100100100000000000101000
00010101110100100000010000010011100010000110010001100010001000001001001100000000010000100000001001100
00011001001100001010010100000010001000010000000110000100110001001010000111001000010101110001000100100
00000011100110000000001101010000110000100000100000011100001110000011000001010000000111110101100101000
00001101001101101101010001110110100010000000000000001110010000000000100001000001101011010000001010010
00101010010010100100001101000000100100101001100111000010111001100001000010000001010010000001000000010
00100100111010011000010001110101000010001100001010010100101110100000010111000100110001100010010001001
11000000010000010010000100001101000011001000000100101110100001001010011011000110000100001011000001010
01001000000000100010100010110101000000110000000101010110001000010001001100001000000100000000000010101
01010010000010101000100010110010000100101100001000100000001100100000000001010001101100000100000011001
00100101000010001001101010010000000001000100110101000000000000000001110010111011000010010010000100001
00010100101100001100000000100110010011000100010000100001110000001010011000001100011001001000000100101
00000110001100000100010101000100000111100100010000000110110000110001001000000000010011000100100000000
10100100000010000001000011010000000000001000110010000111000000100000011100001001000001001000011010111
00010000101000011010000000001110000010001000011000100010111001100101001000101000000010010000011010100
00000000000111001000000100001010100010000011000000011000000100001101001010100110000000010010100000110
00011001010000000110000111001001010010000001100001101101001011100000110000001001100000111110000000000
01001010010000000000000100010000100001000000010010101000011000000001010000101000110001110000100010001
10000000010010111001001000001000011000100100101110000000110110001000100011001101011010011100010010101
00101000001000001110010000010101100001100010000011100100000101000000000001011101001000100101001001011
00000111000110000000101111000010100000000100001010010000001010010000100000000010000101100001000000001
10011010000110001010111000100100010000000000110001101010000100101000101000000000000110010000000100000
01000000100110110000100000010101011000100000100000100000001101111010000001000100000001000000000101000
01001010000010100111000100000011100010000011010101000001011000000011010000000000100110010000100101010
00000000100111001110000000000011010011100110000000010000000010010001000100011000100101010111011000001
00011000011000011010100000010000010000000001100000011000101011010010000110100010001000000001000100000
00011000000001001001000001110001111000000010000001100010100000010011000000010100000100110011001000111
00001100111000000100000000000010100100010000001110000000000100010000010100001001100000101010101001101
00100010000100000100010000100000100000000000000100001001010010100100000100010100000000010100110101100
00101100001001010000001011011100110010110000001010000000100000110100000011000001100000001100101000010
00001000000000000000010101001111101100101001000010000000000000000000001011110101010000010100101000000
10111001000101010000001100101011000001000010000100011000001000000100000100101110110000000111000101110
00101000011111000000101010010000110101010100100000001000100100000101010100000001000110010101100000001
00100110011000001100001010110010010000011001010001100000100010000100100010010001110000101010001000000
01100001001000010100100000100100000100000000101000000101011000100000000000000000011000110100000000111
11000100001000001000110100010111010100000001011000001010101000001000111001001001011011001000001000010
11010000100011001000010010001111000011000000000110000001101010000001011000000110001110001010100000010
01110000001000010010100100000001111100110000110100000000000111010000100001110100100100000001000000100
00011001000100010001000000000001001000111100000011110000001100001110110101010000100001010011010000000
10000000000000001101010101001000100001000010101000000010010100100101000001000110000000111000010100010
00000000000001011000100000000000010100001000011010000001000101001100000110100000110100000000010001010
10001000001010001110101010000110000000001110001101000000000000011010110101000000100101001100110000000
10000000001000000010000100000000000001100000100011000010111100001001000000000000111000000100000000101
00010100010000100000101000001001000011000100000000010100011000011001101000000010100100010001000101001
00001011000100101110101010000010100000000001000000010000010010000010100000001101101110100101000101110
10101010000100001001000001000110000100001010010000111010111001000001010010000000001000010010000100001
00101001000100110100011000100001000110001010001010010111001000100001001010000000110010001000000100010
00010110100000011011000010011111100100000010000000011000011010111011100000010100100010111010001000000
00000001000000000000001010001000000001000010100010111010001110010001100001110110010011000100000100100
11000010001000000000100101000010110000000111000010110010000110000100001000001001000000001000001000000
00000100000000000111101010110001000010000101100000100000010010010000000010010000011000111000000001001
00010101111000101000100110000000110010000010100001110100100110000001000010100000001000100001000101101
00000000100001000010000000101011000101000110001000000110011100100001110000011100100111000011100000001
10100000100101010000110001100100100001000100100000011010011000000000001010001101001001010000100000100
10010100011000001010001101110000001000100100100100011111001011000010000000001000101000001110100000010
00010000110000011000000110000001000000000000000011000010101001101000010100110000000010000000100110100
00000010100000001000000000101000000000110110010000001101000101000000100101000001101110100100000000000
10000100000010000000001011010000100110100100100100000000000010111001110101001011100000010001110000110
00100000000001000010100000001110000000110000101000000001101100010110000000001001001000000000100001000
