01101000100000101010010100010100010100000000010000001011000010001111010000110000000010100100010011110
00011001010011010101001111100010000010000000000001000001000000000010100000000001100001001101110000000
00001000101000101001111001001001110011100111000011100100010010011101100100000000000010100000110011100
10111000110111000001110101000000101001000010010010101110000001001111000000100000000000000100111100001
10010000010110100001110010001001000100001001100000100101001110000010110000000100011000000001100100001
01001101111000110100000000000000010011010001000110111000111110000000010010000000001100000001001000001
00000110000000100010000010000000000010011010000000000001100000011000000001101010111100000010011010000
00000001100110001110000010110000000000001001000011000001001000000101010000001101011110000010110000001
10011101110101000010000110100000000101001000011000000110100100110010000000100011110100010100000000011
10000100100100111000001001000000000000100000000011011000100000001000100110100000011000000000010001100
11010100011000101010001001100000011000000000000000010000001011010000000101000000011011000000000101011
00100101010000010100110010100010101101001000011001001000000000111000100000000100010000010001000010000
00010011100010000101000010000101100011010001010100101000010100110000101000010110001010001101100000000
00000000001011111010011100010000000000101001001011100000110000010010010100001100100001101010001010101
00000000000000010001010000100010000000010000100000000011000001111001001000000001000101110001100011000
10001101100110000000000101010000011010001100000000001000111100000001100001100101101001000100010000010
00011110110001100000000010001100000101100011101000101100110010011100010000010110011100001111000000011
00011001000000110001000000010010100100001000000100110100000000000000011000000100000101000111011001001
01011100001011010000100100110000100000010010101000000000100100000000011100010110000100011000001111000
00000001010011010100100100000011101001101110001000010100000100111110000010110000111000001110000000000
10001010011100011011100010000001101010001100001100010000000000011100000000010001100110110100001001010
10000000000011100010100000011010000101000100000001000000000010100000000100000100001001101000111011000
00000000000000100000101000000000000001000000001000001100010000101101100100000000000000000100100000110
10000101000101000100001000000100010001000000001011110110000000000101010110000000001001001100001000010
10010111000000010100001001101111100001011010111100000000010101011000100000001000000000011000001100010
00010010000101000110000001100010000011010110011100000000001110100000000100000111011001000100000111000
01000100000010100010101000000000001001100000010001000100000011000000100100011000110101000011010001000
00000001000000000000000000000000000101001001010010001000100110010010100010111000100100000000000001110
01001111010000010100100000010011000100011000001000111100001100000010010100010011000110000010000011000
10000000000001000000010000001000000000011110000010000111100001000101000010100000101000000100001010101
00000000100100110111010011001001000000000001001100100101000000000000001000000000000110010010000000001
10010000000110011000000010000010100010011110101001011010000010001011100100001010000010101001001010000
00010101100010001000100010000100001000110000101000100000100110001101110000100100001010111000110100001
10010111101100101011000001000000101100010001010010010011000100100000110001110000000110001010000000000
00000001001100100000010000111010100001010000100100000000110111000100111010011100000000110101100001101
10001110000000101000010000001000110001000000000000010011011101001001101000001000010100001010000010110
00000010100101000000011000000010100000110000101010000010001000000001000000100000001000011101000101000
01000000000011000001100001000000011100110011110110100010011000111001000000001010001010001001000101010
00000000011000110110000101010000000000001110000010000001000000000101000100011000000001100000010001000
00001000101000001010000011001010010001000101001000101001101101100100001110000000100000001000001000000
10000100010000100000101000000010010010010000000110011000000010011000100011000000000001100000010000100
01000010101010111000010011101000101010110000001000100000001000000011001000000100000011001001100111010
10000100100001111010110000000001000000011000000001000010100110101000000001000000001000010101000000100
10000110001000000001000110010010100100010010100000000011000000100010011010010100100000100001100010001
10100000001001010010000000011000101101100000010010011000000010000010000000111010001001010000001000010
00110001110001100101000000100010011101010000001011101010010110000011100000100001110110000100010100000
11110111001000000010010000100001100000001001111000000100000010000010010100100010000000000100000101011
00000101001000000101001010000000010000001000110110000000100000100110100100000000001001001000000001011
00010000010001011110001111000001000000100000000110000000110001111001010001000011000011001010010000000
01100101100001100000110001111011110000000000001101110000011011100101111001010100110000100100001001100
00000000000000000000101000100000011100001000000010010100101001011000000011100111000000000100110000000
01001110000000110010100100100000000111000000000100010010100011000111010000000101000000101001000001100
00000110000000110000100110011100000100000000010001000110001010000000110001100000110001001001000010110
00000001100000000000001100001001001000100000101000001001101000010000000100011011100001000100000000000
01010100000101100100100000000111000000010001010110000001000011110000010110100001000101001011110100000
00101000100010000100100100001001001110001000000101100001010000000001000100000000110001110111001001000
00000000110001001000000001001111010010000001001010110000100001010000010000000110010110000000000001001
00001000000101010101100010100000010100000000000100000000100010001001001100000110110000000000011110000
00001010010001000001001000000000000011100000111011110010000110011110000100000100000000000010000000100
00000000100110000001000010101000000110000001000001000010010110000010110001000011000000000000000000010
00000000000000010100100000011000111110001110110110100000110001011010000110101010000000000000100000000
01010001010100001000001100011100100010001010110100100110000010000000010000100010100010010000000000101
01000000000000110001000010100001011000010101100010010000110100000000100000101000000001011011001110011
00001001000000100000100000001010010001001111000000100000011110010010010010100000000011001010010001101
00011000000100010000110001101000000010010000111000000000000001110111001001010100100000010010100110000
10000110100101000010000110100001000100001110111111000000000000000000100010000001011100000010100110101
01111101000010011000011100001000110010000000010000000000111100000010010000001010001000000001000011000
00001101011100101001100000000110000010100110101101010000000010000000101000100101010000110100100000110
00000001101000000100100100111011000100000000110010000000001100000010110101010100100100001100100000011
00000110110000000010000100001100001000000010101001100110001111100000100000000001000101110100001010000
00100011000000001101101000101000100010001011000000000011000000010010100000000000100100000110000000001
00000100000011011101100010100000100101000000111000000100000000101000011000110001000000000001000101010
10100101000001000000000000100000000101010010011100001010000011001110110001000100110001010000001000010
10000001110110000000101101100010010010110000101000001101101000001100001000010110001100000010010000000
10110110000101010100001000000111101011010100000100000110010010010010101010000100000001000000101010100
00001000011100001000010010010100000001000000000100000101010111110001101001000110001100000010010110001
01000010011001110100100000000110111000110110101100001010100001100100000000000010100000010000010000010
00000010011000000001110000000100100000001011100110000000000011100100010000010000010000000100110011100
00000001000100100000000000000100010000000000000111000000000110010000111010100110111001110110000000000
10000000101000100100110010000000100001000000000100000000001010101110011000000011100000100100101000010
00100000011000110100011010001100101110001011000000100001100110000000000000000100110000000000010110000
10100000101000011010010010110000011111010001010100111100011100000010001100000000000100000000010010000
01000100010100000000000001000010001100000100100111101010000000100110100010100000010001000011000010000
00010010000000001000101000000000001000000001010001101001000011100001001000000000000110000100001010100
10110000010000011101101001100100101101000000000110100000000001110110101011000000100000000010101100110
10000111000001000000100010100100010001011100000010110001110001001000010000001000100011000110110100010
00100010000011000111010101110110110000110001001110001010110001001001010000100001010001011000000000100
00100000100001000001010010100010101101100010000011110000100100010101001001101000000100010010001000000
10110000000001101101100001010000010000100010000001001001001110100010000011101000100001010100011100010
01001010000111001000000001010010011010000100010000100000000000000000100010011110000111000110010010100
00101000110000001000100000001110001111110101010000100000011000010000001011100000100010000000000010101
01000000100110000100000000011001011000100000000000000000000000000100010000000000010010111000110000000
00100011011100000011000100011000101010010001000000000100101100000000100000000001000110000010011000111
00000000010000001010001001110000000000010000011010001011100011110001000100000000000010011010100000110
01000011001000101000101000100110000010000001101111000010000010001001010011001001011010110000110010001
11000010001000001001001000101111100000010000000100001000000100100000001001001110000001010010000000010
00001111101110001000000110110000001101101000000001010101000000010010101110000000000100000101010001010
01011000000110100110100000001100000000010101000101010101001000110001010000100000001001001000110001001
10001100001110000001010000000011110001001100010011010100000001011001000000000000100000000011110000010
00001101000000000001000100000000010001011010001000000101100010000001011010011010000101000010001100001
10000010001101010001011100000010010000100000000000100010110000000000010010000101110000000000000000110
