00001000101000010010010010000101110001110010010110001000001110011100011000101001010110100100000000000
10000100000000001000100110001000001000001000101001001000001001000100100100000010000010001001001110001
00100100000010010110100000100000001000100100010001000110001000111101000001000001010011101000010001100
10100011010100011001100010100100010110000010110000110001001011000000100000011000000011000000100000000
00101010100000000011011000010001110000010000111001000000000011110001010001000000000100100001000100001
10001100000001000010010011100001110011010100101001100000001001000001001000110000001010010001000001010
01111010001000000100011010010101000100011011111001100100010000110100010010000110100000011010110000001
00010000100011110000000100101100101010010100111111101101001110100100111011000000010001000000101100100
11000000000001010100001100000000000000110001001000000001000000100010110000001011011000001000010010000
00001001001010000000000000111011010101001001110010111010100001100010101001100000010000000100100111001
00101010000110001110000100000001010100000000101000000100000010000010110100100000011000101110010000110
01010000010001000100000100011101010001011000110010000000000001101001010100100100100000000010111000101
11000001110100000000000001100000100110000001010000001010100000011011011000101000000100011000000100000
01011011001001010000110100001010001010000101000000101101000110100111000001101110001001000010000000000
10010111111000001100101000100001000000000010100000001000110001010001000001011101000000001101010000000
10011000100110100000000101110010010010010000011111101001100001000101100000000000000010010011110100000
01010001101001010000100101010100100100010010010011010000011100010000100110000000100001101000101010100
00000000101100000010010110000000001011100110011100101101100000001000000000001000111000001010100101111
01011000001000101110001000100000011010000001000101000010000101100010110000001101011000001001010101000
11000000001100010010000000011111000101000010000011000110000110000000010010110110001100011000000100001
00000101000000011001110000000111000000000011010001010011100100100001000101000101001111100101000101110
00110100101000001011110000100010011100000000011100000010001110001001000000010000000101000000000010000
00000110100000100100001001000000000001010100000010000000000000000000101001010000010100010001011001100
10110010000111001000001010110111000000000001110010010000001101000110000110100001000010000000110000001
10001010001000100000010110101110000001010010000000100001000010001001000001000000000001000101010010010
11000011010000011100100010110001000000010100001010110100100110001001000001001000000111100000010010000
10000100100000000010011010001000101100010001001000000100110110001000000001100010010110110100001001011
10001000000000111000000110001000100000000100100010000011000010010110100100010000100100110000100001000
00011001000000001001000100000000000000100000001010100000011100000000000000010000110000000100011011111
00010100101100000010010000000001010000101100000101010000000001000000001000000000000001110010110000010
00000001010010100111011100001100000000010100001000101101000100000010000000000100001010001000100010010
00011000111010000001111001010100101001011000011000001001010010000000100001010001111110000111000100010
01100100000010010011000000001100000010010000100100100000000111111000001000001001011100100000001101000
01000100010100111001000100000000100110000000000001111001000101010010000101100000100000000010100110000
00000001100001000000000010110010010110000000100000010001001000001101001000010010001000011110100000111
01000000010100000100110000000000001000000000000001000000000000000000101000100000000110001100000001010
00011010000000000011000010111000000010001011100100100110001000010000110000000001001000001100000000011
00100011000001111010111001000000000000010000111011001100000100000010100000000100010011000010011100000
10110010000001111001000100100000000101000001011001000000000000010000011010011100000100000001110000010
00001010011100000010010011100111000000000110001100001011100100100010000001100010000010010000001101110
10000000000110111000000010000001100100110101101001001100000010101011010010000111001010010001000000010
01010001000101000100110000110000001110110101010001000001110001010010100110110000000000100001010000000
10101101010101101011100010110000010010000010100011001001101000010000000011011101100000000100000000000
00000001111001000100001000001000001111000001001001001000001000000001000001010001100100000010110010100
01100010000010000010001110100001000001001100001011010000001000000100010010010001010010001100001011000
00100011010011000001000110111001010010000010100100010000001100000010011100001010100000100001000111000
00000001000010000001000000010000010011000000000000001000000010001011110001000000100010000111010000000
00101100010000101100010000000000001000010111000000100000011011000000010000000100100101000000110000111
01000000000010100100010000110010000010010010110001000001111100010011001001000000010000001011001100110
01011000000101000000001100010110000000011000101011001001010001010010010000000011001010000100100001010
00000100101100000101000000111000011111010000001011111000001000011100110100100001100111010011001100000
00100010000010100000110000011100001110001010000101110000101101001000100101000100010000000001100100010
00000000001000001100010100001000011110010000000001111001010001000010000010010100000100000001001010101
10000111101000010001100001100000001000110010000000010000000110001001011010000000010011001001110000101
11001001000001000101101000110110000100101000000001000000001011010011000010000101101000011000001001101
10001001110010001000111110000011000000000110000100011000000011100000000110010001111011001010010011100
00010101001010000010100000111011100010000001001001000000000000000001010100011000110011010000100000000
00100101111000000000000000000000000010000100101101000001010000000001001000000100011001001011010000001
01100000000010100000000010011100001010001101110001110001000001100000101010010010010100100110110011111
00000001100010001101000101100010100000001011001110001111000000100010001000001000010000101001101100010
00000010010000000110100000001110100000010100100100010010010100011000000000101000000000010000000010000
00000000001100010010010100000000010010011100110000000000100100000100010101000010100100010001110010010
10000000100000001000111101000011000001100010110101000000000101001001000000100010101001010101000100000
00000010001000010100000100100101000001100010101100000000010000000110100101000000111000100110000100000
10010000000000010001001011010000000001100010110010010010000000001001001110101000000000000000100000000
01011110000100101000000000100000100100110010000001100000010101000010000100101000000011010000101000000
00100110000011000011000000110101100010011011000000010000000000001100000000000000111011010100100100100
00000010011010100010101000000101000100000010010010000001000000011010100001010000011000110000000101010
00010001011001100010000010110000000010001010101110100000010011000100111011000000000000100101010000010
10011000101001100001010000001110000100110000000000000011001000100100001101010001000100010111000010010
01000001000000101000000011101100010000000001100000001010001001000000000000100010011000001000011011010
01010000010110100100000001001101010100010000000000000110000000000100100000000001010000010011010000001
10010000110100000000000001000000000000000001011000101011111001011000001001101000011001100111010100101
10000010001000110100000011000110011010100000110010101100001100000001110111001001000010001100101000010
10111000000011000100101000001110000001010100000001000001110001000010000010000000000010010100010000001
11011110000000000001011000000010011010110101000101001000011100001000100110000010010001100001100000001
00101001001100100010111011100001110000010110010001100000001000100100000101000101000100000000100000010
10101111001010000100011110101010101010110101001000000000000001000100011010000001010101100010000010001
00011100000000000010110100010100000000110001000010010000100000001000000000001001110000000000100111100
10100001010000010010111100010100010011000001111000010000000110010011101001001100001000000000100001001
01010111000100000010000000000000101011000001001000111010100000100000001111000001001010000000110000110
10100110000001010100000000110001100001001001000101010010000111001101010000100110100000000000001000000
00000100000010001101001010100010000000100100001110010000010001000011001100100000001010110100010011011
01000000000001100000001101000101010011110011000110010000010000000001110111000001000011010001100100000
00101000100001010100010000110000100101110100000011000011001000010010100010000000010001000100001000010
11001110101100001111101000000000001001000001011001001000100010100110001110000110011111100000000010010
01000000100011000000101010000110001100010100011001100101100101010101000110100000110010011110100110001
00100000010000000000000011101000101010100100010011001001100000100000010100100000110101010100000100001
00000011000000001011011111100000001000001001100011001000100001110000100001110001011001001000001000101
00110100001000100000111010011010000000000000000011011000000001001000100000000110001101000000101010011
00110010001011000001010000000000000011000110000101100010101010001011100000110011010110001001000001000
00010100010110101001110011001000010010000000100000011000110011000111100101001100001000110000000001110
00010000000001000001001010110000000000010100101000100100101000000010100000011000001010000100100100100
01100000000000101010111000100000110010100000100110011000000001001000100010100000110000000010010010100
10010010000100100000000010000001101011001000100011001000010011000001100000000111000011101000011100000
00000000110000110010100011011110001000111100000000110011110001010110000000001110101100011010011001001
01001010101100101100001000110000001100111010100001100100010010100101011001101000000000100000110111010
01000000010001001000000010010000001000001100110000001010010101010000000110001110101110000011011011100
00001000010110101000000000001010100010010001001000000001000100010001000100000001000001100001010000001
00100000000101001100000000010011000000110000000111000010010010000011100010001110100100100000001000100
00000000000000010110101010010000001101000000111000110000110000000000101110000010010000100100100010111
