00101100000010000010000100000001010001000000010011000101000000111000110001001001100000000000001011000
10001001100000001000010100001100010100100000000000000001110110000100010001001100001000010101000100111
01000010000001100010001010000010101000010000010000010011000000110111100100011001000101001010100001100
00001000111000111010000000000001000100000100000100101110010100101000000100010000000110000000010100000
11000001100001110001000010000000000010000000100000010001000010100010001000001101000100000111011001000
00000101100000010010000000000000100000110011110010011001000000101010001110010100100010001001000010001
01000010001010010100000000000100000001100000110010101101100000000110111100000000111110011110000001100
10000110100000001010100010001001010000000000100001101100001010101101010100011001001000001000110000000
01010111011111000101110001000000101000000011000010010010000011000001010000011101011000001010011001010
11001100010000000100000010000010000010000000111111101100100010001100001100000010100000001000000100000
00000000110110000100000100010000000100100110000110001100100000111001111000011000001011100000110010001
00001000010000000101000001000000000000100000100001010010010010110001000000011000110011000000001000100
01000000001001000001100001000001111001000000100000000010001010000000000001010011000001000100010000001
01110100000000000000010010000000011110000000000000010010010000010000000010001010000000101001000000001
01000110010100000110110010101110001100010100010110110100110000101100000001010000000001001111010100101
10001010000010000100100100000010000110100001000100011110010000001001000010010010010001000011100000010
10000010000000000100000000100000010001000100101000110110001000010000110010000001101000110000100100001
01000010001000000000100000100100000000000111011100000101010010111001000111000011000100010010101100111
00001000001000000101000100100110000000100001010101000001111100000000000000010111001001011000101110010
00000111111000010000011000000001000000111100001010010110100000111000000000000010010100101000010011010
11001101000000100000000010010000010101011000100001001101001100100001001101000001100000010010000101001
00001000111110000010011000101000000000101010000000001100000001100101000001000011111000101011000000000
00101010010100000100010000000001010100111010010000010001000111000111101001001101000000010000001101000
01010001001101000000000010111100001010100001010000101010010000011100101000001100000010000001001000000
00100000000101110111000000001000111011010100000000110101100001100100000000001100011010000000100001110
10000000010011100001100000000001100001000001000101011000001001000101100000100110000001001000000001000
00011100100011010110001110101001101110100001101010001100001100100100000111000000010000100100001000010
10000111011000000100000001000000000100101110000001010100001000000100100000000000000000010101011000000
00100000010001110001000100001000100000100000100000010000100000001000100100011100000011001010001000011
00010011101000000100011000010001001101000010010000001110000000000010010001101000000010011100000101000
00010000110100000000100101101000011100011000001001010111101001000010010000001000100001100000000000001
00100000001010010000011010100000100000010101001000010000000000010010011000001001010000000000001001000
01101000101011001000000010001010010010101011100010000100011001100000010000010000001110110010010000000
11000000000011100000000010010110000000000110100000001011100011001011000000010110001110100000000001010
00000101001010100000000001000010000000110000100010100100001100001000110000001001100100011010000001000
10100010000000000100000011100010000001001110000101010110000000111000111000011100101101011000001100011
10111100110000010000000000111100001011001011000000001010000110000011001100000000000110101010001000000
11000010000000000110010010101100010000011010000000100101100100100100010010000100001101110000010001011
00000001010010001000100010000010001000000000110111100111000011001000000010001011101000011000010001000
10000000011100001000000010110110000001101011101001100100001000100000010010000001011000101011000010000
00011000001101000010100001100010000100000000001000010001100101000011100000110001000101010010001100000
10010001100000010100001011001000000010000001000011010000000000101000000010000101000000001000100000001
00001100101100001101100000100011000110101011100100000010001010001100101100010000100011011001110000000
01000000000101001100010100000001000010000010111000000001000001000011000000101011010000100011010001000
00010100011010110001000001010100100111011000000000011000000011110010000001000000011000000001100101000
01000000110001000010000101100101101111000010101000000111001000100001001000111110010000110000000001000
00010000000010010000100110111011000101000010000000010000010100000000100100001001000000000011000000011
11100010001101110011001011100000000010000000000110000001001000110000001000110010100111000000000000100
10010000000010110010000000001111011001100000000000000100001000001010000011100001011100000000101000110
00010001010011011000110000001000000101010011001110010001000111000010011000001000100100000100000000010
00000000100011000101100000000001000110100001001000000001000010011001100000010010110000000111011010000
10101000111100000001010110011000100000100000101000000110000000000101111000100000011110000010010100110
00000000100000000001100010000010000000000001100001100001000010011000000000000111000000110000000000100
01110110101101000000111001000000001100000010001011110011100001011001010000110001000000011010000001001
11000000011001001011000100010101011000110010000101001000111000001001000110000010101011100000111010011
00000000010101010010100010010100000100100000000101111000000110000000000001001010000000000000000100110
00000000000000010011101011000100100001100001000010000000100100110000000001010000100101001100000000110
10000010101001101000000000110000100000010000000110100100000000000010000000001000001000000001000000111
00001000111100100100110001000001001110000100100000101100000010000001000010011010000000100000100011101
10111100010000010000010110000000101011011000001001000100010001000010000100001010010100011110000100001
00000100111000000000000010010001000011000000000001110000100000001000011100001110101100100001100010010
10001010000000000000101100101001000000110100010000010101110000000001100000000110000000010011000000100
00010110111000111000000101110000100000100101110000000010000110000000010000100000001011100000010010100
11000000011000010000100000100000010101000010001000000101000010010001001001000000001010000011010100010
00110010101001100100110000000011000000000011011000111000100100000010010001100000000101010010111000110
00000101001000000011101000100111011001000000001000000000000000110000101000110101010000001000000100101
00000001001000000111101010100010000011000010000110001000101100011100101000000001011000100100000100100
11000100101010010101001111001001000100000000010101111001010010000000001110010000000100010001010100000
10000100000100000010000101111000011001000100110100010010000000000000111100000100000011000000100100000
00000000011000100000001101010001110010000000000011000001000001000011111001101000000000000101110101010
11010010011001011010110110100010100010001000000001000001000110011001000000000000010000010100000100000
10100100001100010000010001000000000000001010000011001011010000000000000011100000000100010000000000000
11000000100010010100000001010000100000001000000000001100001010001110010000111101000001000000101000101
10100010010101100010010000100000000000000000011010101001110000001110100010001000000000000001000110011
10011000000000000100000010100011011100100010100011100010000100001000000100100000000001000001101001010
10100000010100000000101000110010000101000110100010001010100110110100000000100101010000100000100100110
01110010111000000110110000010000010101001010000000001000000000100000001100000110001010010000010001001
01110110100000011010000010110000010000010000110010101010100010010000010010110010000100110000110000101
10000001000110000100010001000000000000000111000000000001011100000010000000001010110000010000101100001
10100000000111000010011001000100010000111001000000001100000100010010111100111011100010001100001000000
01100000100111010000110010000010100111001001011000010011010101010101010101110001000001000000000110100
00000000000010110000110000000000000110000010101101100001001000101000010001100000010011001110000000010
00110010000010100010111000001101110011001000100000001000000110111101100000010001011000001001100001110
00111100000000100101000010001000111000010000000000000010100010000100100110000000011100011010000110100
00000000010100001001000100010000010100101001001100101001100010011000000000001001001101010010101001010
00010001001100011000000110000001000000010010000110000010010010011001010000001011111011100010000000111
00100000000100000001000001011000000011000100000000000000011011000110000101001110100000000010110001000
00001000011001000010000001100100100001101000110010000000101000111100100000000001000000100111100001110
01010010000111100001100100000000010001100001001011000000000000000101001000111100100000001101000101010
01011100010000100000010011000101010100000100000000001000001000100000010010100101101010101001010100000
01010001001011010101101010110010100000101000110001000000100000000010001101000011110011000001111000110
00000000110010000010100011001010001000111000000110100000001000111100000001101101001100001000000010111
00000010100000010000000010010010001000110101001000010000100000110100100000111001001000001101010010000
00010100000011000000000100100001010000101101010100010011000110001100000010110001101110000000100010100
11101100011110100101100110000100001000011010000000001010000110010011001100100110000010001000000010100
11001000010000010011000000010010110010101000110000010000000010100010000000100100111010110001000010001
01000001000101000001111000000000010000000000001000001001000000000111000100001010000000000010000000000
00100100001001001100000000001001000100000000010001100010000000100100000001100000011001000001110010010
00110001000000000100110000010001001011000010000011001100101111000010011100010100000001010011001010100
10101000010111010100000101000010101110000000011000100010110111100110010000000000100011110000110000000
01001000010000000000000101010010100101000000010000100101100000001100001001111001001000000000001011000
