10011011000110100111000100100010011000001000000011000011000001000000101100011110000001100100000000000
01010100000001001001001000001001000011001100110000001000000001000001110110000011001101010000000000001
00110000000111110000000000000110011011001000010011001001110111000000101000000001001111000000010000010
01000011110111111100100000000011000010010001001000101100000000100111000001000011000000010101100100000
00111101011010000000110000000100011000001001000100001000100010001011011010100010001001110010100111001
00000100001000000001111100000011000100010000011001010110100100001100111000110000000111000000010011000
00000100011000100000000001001001010000010000000000000100000100001100100000000100010001000100010010101
10100111110001110000000101110000111000000100001100000100000111100110000100001000010000011110100001000
00000010000000001001001100011100000011001000010010011010000110111000000111101011100010001000111001000
00100111010000000000001010000000110011000011111000000000100010011000000000111000000001000101001110001
00110010100001100100100000010100001110001100001000110001001010010000000001010000000001000000001100100
01100011101010100000001000101001101010110100000011101010011000001000101011000010100000000000101001000
01000100000000000011011001000001000010001010000100000100100011100110001010000001000000010011010001010
00000001000101000000100010000000000100000101010001000000010000011000100100000010011100101010000101000
01011010001010000110001011000000000101000000010000010000101000010101001000001001011000010000100100001
10100100001000000001001111011110010000001001100001011001100000000010110000111110100000001101000000010
10000000101001000001100000000001001001010010011100001000011000001001100100001000000100100000111010100
11100100100010110010000001001000100111100011000000000110000000011001001010010001010000000010010000001
11100011010110000010000101101111000100000001001001000010001001010000111000110100001100100100000010100
10000001000111000000010000001000001010000101000110111000000100001100011011000000001101000110100000001
10100100100001000001100000000000010101000100001010000011000010001000100010010011100110000010100100010
10000001001010100100101010110000000000100100000000000000001011101000001000001001000000000111100100010
01010000101010000000101111100000101001011011000000010000000000111000000100101000000110000100000000000
10000100100001101000000011000000001101000000000010011010000111000000110100101010010010001000000010100
01101100010000010001010001011011011111100000000000000011011100000100110001010100001100000001000000110
00011100010101010100001010000000000100001000000100001010000100010000000001110001001001011101001000001
00001000010011101000010100000001000000000100000000011100100000010011010110100010011011010000000010000
00001101001100010000101000100100000001010100101000000010000010000000110000100011110100000010001011000
00110010000001011100001000000000000100001011000110000000010010101101000001011010000000100001000000100
00100000000011000000110101001010000100000000000001001101001000100000001000100111000000100000100000100
10000110100000000110010010001110010000001000011101010010001111110100100000010101010011000100000111000
00000101001100000001100000010000000110100000010000110000110010101000000000010010110010000110000000000
10100001101001111000111011000000101010000000000000001010100000010100000001000000000110001110001100001
11000011000100100111001000000100100010000110000001011100000100010000001101110001001000000001000110000
01100010110001111100000110000100100010000000011001000001101000001010110001010100000011100100100111000
00000010011010000110011000111100010001001111100010000101000001100100001001001000100110100000001000000
00010001000000101000101001111001010000000011000000000101000100010001000000111000100000100100100000000
00000000101010000010000010100000001100000010001110001000000010001000101010010110001101010000010100100
10000010000000101001010100010000010000101100010000100001101010111110110010110110000011010001100100000
00001010000000010000001010000100001001010010101000000100001110111001100011000010001000001001110101100
00000100010000011101010000100000011010110101110110100000000100100100000010100000000000100001000100000
00100100001000000001100001010010000000000010000100010000100001000010010000010000000100000000010000010
00111101001000100000010000100100101001000001000001001000000010100100101000000100011000110000001001100
00000000000101100010110000110000000100001000000100110001000000000001000000001101011100010100000000010
10110001101111000000010000000001100010100101100001110000000011000000000000101000110001101000100001001
10000000011000001010000000010110000000010010101010000101001000110100001000011001110110100100001101000
10100101000010010011011011000100100000000000010101001001010000011010010000100010001001010001110100000
10100010000000111001001000000000001100110000001001000010000000011010010010100001010010000001000000001
01100001110001000110000111000010010010101100000101010000000101101001001000010010011000001010000100001
00101011100000000001000100000010010001100001000000000000000010000010110001110000100010000010100010101
00000010000000011001011100000100001010000100011101010101000000001100011110001010111010101000010110001
01101000010000000010100000100010100110001001010110001010000100101010000010010010010100110000000000000
01000001100010000000000001000011001000100000010101100000100110100011100010111011001000011100000101010
00100000000000110100101000010100000000000010000000001101110000001000010000100100100100000010000000100
00110000000001100000101000011011100011000000110100000000000111011001000011000000000000100010100000000
00111100000011000110000010001011000000000010100011010011100100000000010000000100000011111010110010000
01000010001010101000110010100000000010000000110000100100000000001000101001000000000100000100000110000
00000010000000111000000001101100001011100000010110001010011000000000000000010000000000000010100100000
01000010000001000100000000000000010110010101000000001101101000010000010101000011000010011001000001000
00010000001010010010000010100101000000001010010100100000110011100110000110000100001110011101101001001
10000000000101010111001010010001100101000000001000000110000010100000001001010001100000000001000000000
01000100000000000101010000000001000001000000110000010000010100001010010000001001000000000011001000001
00100010111000001001000010101011001000100000001000100110000111011001001010000110100011000001001000000
00011001000001011001011001010000000010100000000100110110011000010001010000011000000000110011001000010
00100010010000010000010001001000000000000000101000000000000000000101000000100010100000000000010001100
10011100001000010010000001010000010000100001100000001100101000010001000000011000000000000010010010001
01100010101100010101000101001010011100001010000101010110010110110010011000110100000000011001000110001
00001101100110011000011001001100100110000011000010000000000000010000010010101000011100000001110001110
11100110000100011001100000001100000110000100001010000000011000000001100100100100000000001000101000000
00000010000000011001011010001010000000010011000001010010001100000010000010101110001010010010010100100
00010000001001110000000100110000100011000100011001101100100101101001011101110000001010001000000000100
00100001000001001000001000000001010000100000111000000000111010000101110000000100000010110010001111010
00010010101000001000000001011000010010100001111000100001111000100000100101000000000100000101100001010
00100110001110111000101110010100001010000000001010000000000011010000000010000100000000010000000000100
01110010001100001010100001000010000010100000001000110001000100110011000011001000110100010001010110010
00000100110110101011010001000010000100001000100000010000010011001011110000011010001000000001010010000
00100000000011001010100100001000110100010000110101001100000101000000001000001101000010000001110100100
01101010000010100001000001000000010000000000001000000001100000010010100010010010000010010101001110000
01010100000011000000100001010001000010100010101000110100000001000000001110101100101000000011000010000
00011000110000000001001100110000000001000100000000000011000001000011110100011000100000100010110101000
10001000001000100001000010000110010010110000010001000000001001001101001001111000101001001010011010010
00111100001011000100000001010011000000110010000000000011001100000110110111000101111100000000010100001
00001010000110010000000000101001001100000011100001110010110010000000010101000011001110000101010000110
01010011000100101011010000001100010010010011000010000100000000100100000000010010000100001000111000000
01001000000100001001000101001000001101000000010001101011000000000100110100001011000111110000000000000
11010010001001111100010100000000011001101111010000011010000100111000100000001100100101000010001010000
10000011010000111010000001010101011111000101000001111010000010000011000001100111000010000000100001001
00100010001001110000010101010111110010100100001000001000010100011001011001110001000111000000110010010
00101000001001000100101000000011001001011000000001001010010010000000110110000010000010001011000000001
10000000000000000001111100000011000010000100000010011101100100000000110000000100000000101110010110111
10101100111001100010000010000000000100001000101000000000000010110010000001001010100001001000110101000
01000000100010000010010001110100000101110000100010100000110011010000000010101111110001000001010100000
11101000011101010110010000000100100000000010000010000000101000000001000010010001000010110101010000010
00000001000011100101010000001001100001000001000000100100110101000010001000000001001000000000100000000
01000110010001011000001001001101100101101001010000101010111000000001001010000011010000000101001000000
00000000011001010001011100000011000111000010000100000000000101000000000010000100000110101110010001001
10100110000111000001011000110011000000010001000110100011101101000000000001010111010010101101100010110
11110101000100010000011000100101100100001001000110011010100001010000000010100100001001010010000100101
01000001001111000100000010010111000000100100100100011001100110000100100010000001001100100000101100011
11101010101010110001001010010011001001110001110101100010000100010001001000000001000011010000000000001
00000010101000101011100001000000001000000000000000001010000001010001000001000010011110001001111000000
