00000000011010000000001000110010000000110010001010000011011110001000001000000011001000000110000001000
10001000100000100000011100000000000000001000001000000100010101010011100010010000011000101001000010010
00100000101000000001110100001000000100010011100000000101000000001001100000110101111100001000100000011
00010010011010010000111000001010000000100101011001101000000000010000111000001000000101000000000000000
00000000001000000000000100000100100101010100010101010001000000111001010001111000011010000101000000010
00000100100000000100001111010000001010000001011000100001001100010000101100010011000001000010010001010
00000000100100000000000000110000001000100100001010001000011101000011001100100011011000000111010110001
10010000100100101000000000001000010001110011000011011100001110001000010001110000001000000000100100111
00000000000100100011000011000011000100000010000000000110000000110001101000001101000000000100110000000
10000010000010000001110100101100000000010000101011100100011000100000101010010100110011101000100001000
00101000000000100000110001010010000001110010101001000000000000000011010110001000010001001110011010110
00000100001001000010101000001010100000101011111000010010010000000000000100001101000010001000111010100
10000100101100110001101001001010000000001101000100000000001000000111000010100001010010010110011000001
00010000000000001110100100010110101001101000000000010100000001000001001000001111001000001100000011100
01001000100000010100001000000111000011001011011100010100100010000100000101000111110001000001000010000
00000100000010000010001101000000110001100000100000100000100001010001100010001000000001000001110001100
01100001000010011011000010010001001000100000010110110000000000011101110001000001000000001100100000000
10100001001100000001100000100010000001000010011100000100010110001001101000000100000000110000101011001
00100011011010000110011110000000001000001100001000111111010010000000010100010010000001000011100000000
00000010100010010000100000001101000001010011100000011000100010000000101001101000110000000000001010000
10010000000010000000101110100011000010111010000100010101100010010100010111001100100000001000101111110
01000110001001000010010110100111010000000001010100000000010100100001000000100000010110000000100000000
00000100100000000101100000000000110110100001010010000001000000100000000101011101001011000100000100101
10011000000110010000001101010000111100000000110100100001000010011000000100000010101010000000000011100
10011001000000000100100100001101000010000001011011010100101011000000101010111011000110111000000011001
00100100001001010001010101100000000000001000000001011000100010000101100010110000110000000011101000100
00000000000101000110100100110000110000100011101000100011010001000011010110001000100100101110110001100
10000100110001011000010000000001000110100000001010011000110010101010001100001000011000101010000001101
00000110100000000100001000110001000001010011001000011101010000000111001000010011101010000010001000010
10000000000010010000000110100010010101000001101010011100000000100001100000000000000110001000000100100
00100011000000000001101000000001011010001000011100100010100000001011000100001000100101000000001111100
01010000001000010000110100000100000010001001010110000010010001000001000000100111101001010010010100000
00000110110000110100001101001100000001101101000000010000001000010001000000001101010010000001001110000
00001000000100110110001010100110100000110101101010100100000000001101001100000000110100010100111000101
01000001100000000010000000001001100101010000110100001111010000000001011000010000001011000000000001000
01001000010000100000110011000000000000010001110010010000000010000100010011010000000000101100010000000
10100100001011100011110000000001101100000011100000001100001000001010011000000000010010000001000000001
00000001001100000101000010000010000011100000100000011000000011011000000010000001000010110000111010110
10011000111110100010101000001011000000000111000000000010000011000101101101000000001110000100010011100
00100010000000100001111000010000010000011010001011011000110001010010010000000000001000001100001100101
00001000110000000100010100010100101010110001000010000000000000000011001011101101010000001000010100000
01000001010000000000000010010100000010011100010010011000000010011010010101001000000010000000010000100
00001100000000101001001000000010001000000000000001001001101100000100100000010101000001010100100110111
11100000001000100010000010100111000001000010001001100100110001001101000000011001000100000000100000001
00000101000010000000001000001000100001010010010101101111010011001011100010101000101010010001100100000
10010100000010000101101001000001101100011100011000000010110000100001001111100001000000110001000000100
00101100010001101000000000000000100000100010101001110000100000011110110111111001001010001011010100000
10010001110110011101110000000000001000010111011010100110000100000011000000000000000001011000000000110
00010001000000110001001000100100010000010000000010011001100011110001000100110011000101011010000100000
00000000001000100000010100101001000010010010110001000100001011100010001011000000001100000000000000100
01100000000000000011010000001000000000101101101011000000110010001000100100010001001000001010010000000
00000010000100001100000100000000100001000100101001000101100000110100010000000101001100000000100010101
01000000110100100011011000011011001011011100110110001001110000000010010000000010011011000011010100000
00011100110000000110001000000100010000010101010001001000010010010000001100000000001000000001000100001
00101100010100010000101110000010011001011010010110000010100000001001001101000000100000110001000100110
00010110010001000110000010100000001100010100110000101100011000100001110000000000011000000100000001010
10011101100110000010010100011100110000100000100000001001000000110100100000001011010011100010000010100
10011001000110000111010000000011100100100100010011001010000000001001101011101001010000001101000000011
00011000010101100010100010010001000110110000001101000000000000100000110000100000111000000100001000000
00000100100010001110000111001000100001010100001011000010000100101110100101000010010100110000111101001
10110000011000001000110100001010001100001110001000010010000000000001111011100110100000110000000000010
00000010000011011000101011101000010100100000000100010001011110000000001100011100011001010100100110101
00000000001000000001100010000101001000000000001001010101010111101101010011000010111110011000100000000
00000010001001001000100100000010000000100110000011100010010000000100111010101010000011110100110111000
10000011000111000000001110001010100000000001000011000000000101010011010000010000000010010000000000110
10100010100011010100100011010000000000100000000111100000001000111010010000000000101100000010010101100
00001000011000001101100101000100001010010000100111000001000000110101000101000000000101110010011000110
00010011100110000000010000001000111010000101010000100010000000000000000100110010001000010100110100010
10000101000000000000111011001000000000000000010000110101000000000100100110010100000010010011000100000
00011011000000111000110001010000010001010000011010000000101100000000100101000000000110000000001100001
00000000101000100101100001000011010100010011001100001010010001001000001100000000010110101001100101000
01101010101011001000000000010000001001000100001100100000010010100011000000111010000000000110100010000
00010110001001110001101000010000000101000100001000000100010000000010001010100010101100010000111001000
00000001000000101011001010110001010011010000101000000100001111000000100000100000101101000001010110010
00101010010001011011000010010111000000110100111000001000101100100000010111000111001100000010000010001
00001001010000101001110000001000001010001000011000010100100111010110000000011111100010010010100001000
00000000110000010000001000101100010000001101001001000010010101000000000010000010010010000100010010001
11100010101000110000100101110100000001011001001000100000010001101100100100011010100101001000000000001
00001001000000000000100000011000011000000011101100000100001001001000100101010000000001000000010000000
11100000010110001000000000000000101001001100110100001001011000000000010001001000110000101010000000011
01010001101000010000101000110000000101100000000001100110000000000011110001100000100010110100000101100
00111010101000001000010110000010000000111010011100001010111000110000001110000101000000000010100000011
00100001100000010010001100001000000001001000000001000100110101010101100000000000000001100010000010000
01000001001000100000000001100000110010000100010000001010100000010100010000100000010001011100001001101
01110101000101000000000100001100000000011011000000011010100001110100010000100000000111100010000101101
10001010000110010101000000000000001111011001100101010010010100000101010110101111000100010011100001010
00000000000001000001000011000000001011100000000000101000000100000000110100010010100111001110000101000
00001000010010001011101011100010000100111100100000101000100000011101010010111110010001001000000101101
10001001011100001010011011000010001000010010011000010000000000100000010100000010001000001010001010100
10000000011000100100010001000100100101100000101100000010000010000010011000100010000000000000110111100
10101000000000110010110000100010000000000010101000100101000100000001110000100001001110001000001011010
00001010010100010000000000010100001000000000010100110000010001000000111000000111000000001110001110000
01000010000000000101000011000100111000000110100000000000101001010011010000010001100010010000000001000
11000010100010001001000000110001010100111000000010001011010000101010010000100000010100000101000011101
11001100101000011100110000010000000000001010100010000001010101000011000101101101110101100000001000001
10100110001010000001001000000011010110000001001010001001000001001000001010000100010001000010000100100
00010100100000000000010110010100000001101010100001101011000000011010000111110000000001000000001101001
00001001110100010001100001000101010010000001010010010001000000000000110000000000001110001001000001000
00101101100000100010101100101000010001010000000010100011000000000001000000000001010000000000010000010
11000010011010011000000011100100000101100000100000010000100011101100110001111101110100000000001010101
00010001000010100010001000100100011000100110001000000000101000001110110001100010100101110101000000010
