00010000000000110010100100010000000010000010000001010000100000100000111001011101000010111010110010000
01000001000000110000001110000100100001000101010010000000010010101110100100000000010000101010100011000
11000001010010100111010110100000110010010000010001100000000001100110001000000000100000000000000001010
10100101001100110010101000000010001000000010100000100000100001010000010000011010001011010001000000000
00010100000000001101000111101100110010011100001100000001001011100110101101000100111110010000001010000
01001100110000000000000110000100000000001100101010010000001001000100001110011100101010101100100000000
10000000001001101010101100100000001000010010001010000010011010101001000010000000000100100000110100000
00100001000000000001000101001011000000010000001110010100000000010000110010010100000100100000011100000
00000101001111000000000000000010001000000000011001001010010000001110000000010100010010011101110111001
10000001001010000100011100000011011110000000000011001001110000001011101001110000101001100100100000000
00000101110101010011001000011010001000000101001010000010000101000110100000000000100000000110011001000
00001000100010001010000100100100000010001000011001001000001100011000011010011000110000101000001001001
10001001001011001010110000001000100100000000010000010000010100100000000001000000000001000010000100011
01000000001100001000001001011111000001011000010001010011000001001100100001001000000001000000100000000
00000110000100000110100010001001000001000000000000000000011010101111000010000101010100111010010110011
01000110110000000000001101011001000001110100100001110110000000000000001100000111000011000010000101010
01010000110100001010000011001100010000010000000100001010011011100000100000010110000001001110000000001
00011010101001010010010000110010100000010110010000000001010001010110000011011000001001000101000000100
00110010010000000011011101010000100100100000100010001011100100011001010111110000000000100000001111010
00010000100001101011000011101100000000110001001000101100000010001010000100100000010000000000110010100
10100100100001001001100000111111010100101000010110010000001000000000001000010000001100001000010000100
10100110000101010001000001000000001110110100001011000001010000000000001000110010010001011100000000000
01000100010000100010000000000000101000001101000101010000001010010001000000010001000100100011000110100
00010011011101010000000100001111001000000000111001001011000010000010010101001000000100000100101011101
01010001100110001011101000011000111110000001111101001101000100000000000010000010101001000001010010000
11010000000000100000010001001010000000110101001000100000000001001100010011000101101000000110000011011
00111110010110001000000000011100001000100000000100100000100011000000000100000100100110000010010101100
00000000010000010001100001111111100010100001101000100010000010100010000111000100011111110000000010000
11001000100010001010000000000000000100101110100100101000101101000001000000010000000000010101010000010
01000000011000100010010010100000100000101001011000000000010100011000011100110000101100110001000000001
00111001100110010000100000000101000001001000100010000000000000010000000010010001001010000000100010010
00011001000100000010011100001011000000110000110000010100011010001001000001100000100100000000001000000
00000100000011000000000100110001001010000001010100001100000000011000010010100101000000001000010010000
00000100000010011101000110011100000000101100001100110001001010011000000000111000001000100000001000101
00000010110001010000011001000001000100001000010000100011010000010000100000100000011000000100000100000
00111000000000101011000100101010000110011000011100001100010101000010000011000000000101101001001100000
00100000000000001000101000100000110000110010011000101001010001110000110000101000010000000010000001000
00011000001010001000000000010110111100010000111001000110010010001001010010100001000000001010000010110
00001100100001001100010001000100100111010010000000100010001001000001000010001001000100001000010101001
00011101010001000011001001000000000011000110001001100110100001010100001100010010100000100000011000010
10000010000010000101000000000000101100100100000000100000000111010000100010100000000110000011000101000
01000000001001101100010001010010000001000000010000010110000011000001000110000000000011010000000100010
00010010000001110100100000011000000011001000101001100011010010010100010111101000010110100000000000001
00000010000000110000010100000101110010000100101110010100000001001100100000110000010011010001110000001
00000100000000010000100010000100000011000100010001000000000000101110011000100010011001000101100000101
00000100011100000000010000011110110000000100011000000100000000100001100000100001101000000000101000100
00110000000000110011011111100010111100010001000000100010111100000000110000010000000000000000010000001
00110101000010100100010010100100101100100101000110010000000000000100111000101000001001000101000000001
00000010011010010110110000011001011101000000010011100011100000100011000000000101000001010100011000100
10010001011010010100100000010101010000000101010100000101110101000000001100000100000100000111001011110
00011000100000010011010001001000100101100001011100101110010100110001011000100001000000011101101110000
00010110110010000000000000100010000000011000110001011100000110001100101000110000011110010011111110110
11000000010001001001001011000000010000000110110101100100100100010000000001110110010100000100010000101
00000001010110001110000001101000011110000000000010001101111001010000111010000001100000101001101000000
10001000010110000000000100100000101001000001010011101100010001000010001000000000101000000010010001010
10010000100000111000100100010010110000000010000001010010010100100010111010011010101001010000001000100
00000111001000111011100011010000101011000000001001110000010100000110000111101100001001000000010000000
10000100110000100001010000011010000001010010010001100000001100001100000000001110000000000010000001000
01011001001011101011101000000001110111001000000010001000000000110010101111000000000100000000101100011
10110000010010000000110010000000011100010001001000010000000000010010000000010110000100001000001110100
01001000000000111000110000100110010001101010000001110011100010000000011001000100101100100100001101100
01010101100010011100101000010010101010101110010101000011110101001010100001100010011000000110011000000
01100000110001000000110100000100100110100010000111001010100011000000010100001111000110000010000101000
00101000111010000100000000000001100000100001001000100000101000000101000000010010001100001101100000010
10100000100000100101100000001110111010010100000001111000010111000001100000011000000001000010100001010
00000011011000000101000010010001001001001000000000000010000000000101000001101000000000000000000000100
00000000010000100100010110011111011100100101010010110100000100111111000000000001000101100011100000000
01000000010100001000001011100100000001001001101010000010001101010000110111110000000110101000001000000
00010010000000000111001001001000100000101010010000100100000100001110001110001000001001100110000000110
00000101010000100100000001100000111100100110001100010100000000000000011000111100010000001010011100000
01000101100010001100110010001101010010000010010000001000010000010000011100001000010000011010101010001
00110000001000000100000110001000000000100011100010000001100001000010011111000100001100001100110000010
01011100100000110000110001000001100000011001000000100001000010011000000100001010011010110000011110100
10000001010010000000000101111001110101100000001000000010000010000110010001010001101000101000000100010
01001011100000001000100100000000010000010010110000110010010011000101100010011000000000010000000100101
00011001101011001011000011010001110010110000000001001000100001001010100000001000110111000000010110100
00000001010010010100000000001100110000010001010001000000000100101000001000100001000001000101010000010
10001011000010000110110000000011110000100000001110110011101110000000000100001100101100101000010100101
00101001110000001100000010110000010111110001001010010011000100100110000000101000000000101100001001100
10000010101100011001100101100000011100011000010100100000010001100011100000110100001100101000000000110
01101000010000111000000111010010100110000001100010100010001000010110100100010011000100001100000111100
01100001000111000000100001000000000000001010001010000000011110110101000001101001100010000101001110010
00100000000100110000000000001010100010000000001100010001100100000001000010000101000010000010000000100
00000000010110101010010001000100000011101000000001011000000101000010000100001100011000001010101101000
01100010000001010000000000000000001100001100001111010001001001000011000011000000101011000100000000001
11100101000010001011001000000011010001000001110010011001010000001100100001011100010001000100000000000
01000001100010000110110001010010000101010000110000000000110110010110000000100100000000100010111000100
00101000000010011110100100000100100000000000010100000000011000010010110000000000100000100000010000100
10001010000011110111000001110001000000000111110000011000000000010010000100101100001100100110000001000
00000100000100010000000100000011101000010100000010000000010001001101000110100001000000101000000011010
01111010000000001010011001001011100001000001111110010100001010001000010010000101100010010001100000010
10000000011101100000100000001011100100100000001101110111000000100100000100000100010000110101001000000
01011010000100010101000010001001000010000000000000000110101000101100000000100000101000000100010000100
10100111001010100110000010011000011000000100110000000100100110000010000001000001000000101000000001001
00001000100100000000100001000000011010111001000110000000101010010100100001010000111000110000101001100
00001000000000100100100100010000110000001011000000001101100001001100000000100001101000000000100100100
01000100001000100000010100110001001001000101000100011110111000111110010000001000000000001001001001011
11000000000000000000000010000111000110000001011000000001000000000001110000000100010011101000100000010
10000100000001001000010111100100000100100111100100011110100000000000000000001100000011001100000000000
11000000000000101100101001100101001010001001000000010001101010001000000111100100000101100001001001010
10011100000010000000011100001000010000100000110000000011001001010100010001010010001000000001111100100
