00000000000001100001010110000111000100000000000010010001000100000100011110000000000000011000100100001
00000000000001100000001000010000010010001000101001011000011000100010000010011001101000101100000010000
00011100100010000100100110110000000000100011110110011110000000100000011110010000000111010100101110100
11001000010010000011001000011100011101000011100011000010100010000100000001001000110000010110000000000
10100000101001000101001010011001110010100001010101010000000010000010000000010110001010111000000000011
11100011000001000000000011100100000110001000110110100001100101111010011000010100000000011000010010000
01110010001110000000001000110001011000110000000101010001001010110110100000001010111101000010010000100
10010000010011101000000000000100010001000000000001000000000010001001010011111111100101110000010000000
10001101001001100010000001101000111100100100011110000000000000010110110100100010000000000100100000100
10000000000101000010000000000100000010001000001100000000001011110000100011110100100010000001001000000
00000010000000010010001001011110010100010110101000100010010110100001001110001010010010100000000010001
11001100010010000110000000101001000001000010011000110010000101011000010011000000001100010100101000000
10111100001000010001010000000000101000001010000000011010000010111000101111011100000101000100101010010
01100001000000000101000001100010100110010010001011101000100000000000010010010100000101000001010010010
00001001101100100000101000100100101000000000000010000000100001010000000100011110000001110000100000110
00000000101010000001101011111001000000011010100000100001101000001000000100001100000001110000100001100
00000000110001000101000011100100100000100000100000111001000001000001001000010101011010000010100001000
00010001101001010000001101000110011100000110001010001011010101000000000010001000000000001100100001100
00010010110100000101100011010110000010001100000000100101000010010101001000000000101110111011110000010
00110101001100001000100000010000011000000010010001010101011000010010110000100110011000000010001001000
11011011011000001000010001000100000101010111001001001100100110001000100000111110001100001000100000001
00001000010010011000000000000100000000001001000111000001010000101000100100000010000110000000100010000
10101100000010100100000000000010000011001100101000100000000100110000000011100000000101000001000000010
11000001101011000010010101001111110101100000000101000000010100101010100101001010000010110000010100100
00000110001000001000111101001100110101000001100011101010011110010100000101000010000101000011100000011
00000111000011100100001100011010010010000100010001000000100010100100001001010000011010110101000010000
00000011000100000000100010001000001101000010000000011001000101011000010101000010100110000100011001000
11000000101000110011100101111001001001101100001010010001110000000110010001010001010000110110001010101
00010001100010101000011000001110000000100010000000000100000000011101010000000011001000111001111100000
11101010101011111001010011111011100010101000010011011111111100100001110100000010011010001100001010101
00000010000011100100000000110100001010000010001001100000001000000000000011010110000010000100000001101
10001000000000001101000000110001010110000000010000000000000000001010001000000001001011100000001000010
10000101100010001000100011000100000011111001100000100000010100100100100000000110101000001100000100101
01001100111001000011111011110000101000000010011000010000010100000000000000111100000000111001010000001
01100100000000100010001001000110101011010010000000000000010110100000000100000011000001000001001000000
11110010000100001000111110101100000000010000100000001000000110000000000001000000000000110011000100011
11101111000001000010000000011011000001010100001011010000001101000000001001100110010010011010001000000
01100000000001000100101000001100010011000010100100001000000010001000111000100100100000101011000010000
00000001000000101001000000000010100000101000110011001011000101011000000000000001101001010011000000001
10000001010000001011010000000001000000000010000011000010010100010100101010000100000100000000011000000
00000000101110111001010000010011110000011011000000100000000011001011000001001000010000101100001010101
11010000000111000011001110000000111010010000000010010101001110000111100001000000001101000010010011000
10001001000000100110000000101001001000000001001100110011001000001010010110010100000000111100011100000
11010010110001100000001001000000101100000110000100000100011100010101011011010001000010000101000100001
10000110000011001000000100101000000101010000000010110000000110000001101110100001001000100000110000101
00010010010010010010000001101100010111110000001000000001001000010010110011000101100000000000000000000
10011010000001010110110000010001101010100100100001000010101010010000100000100011010000100010001100000
00100000010110110000010000111001100000000100001000000101000000000100110000000111011000000000101000000
00000001010000000100100000000100000000000101010100100111010000010001000110000100001100111110100010001
10000010100011000011000000000110111100010101100000000111000000010100100001010000101100100001001010000
00100000000010111001100000011100111110000010001000110001100000001010010011000101000000000000000111000
00100000010101110000100000110000001000010100010100001100000100100111011000100000000100110100001000011
00010000100000010000000101010011110000100000101101010001001000100101001000000001100001011010010001100
00000001001000000000001010000000001101101010000101000010000001000000100000000100110100100000000111000
00010001000100001111000111000110101000000011010100010010101100010111100000000011000010010101110000011
00000010101001100010000000011010010000101001100100000100100001001001001000010000001110100001000000000
01010010000000100000001000000001001100001010001110101110001010000001000110001100000010100001000000000
00010000001100000110001000000010000100110110110101110010110000010011111000010010001100000000001011100
01001001101100000011010001001100001001011000011100010001001100011000000101100010001001010001011000100
00010000100101101100010011010000010000000101000010000010010001010100010101000000001000000100101001100
01110100010001100010101000000001000100110000010000101111000010110100001000001110100000000001000000010
01101100001000101010001111010101111101100000000110000000001011000001000001011011000010100010000100000
11001100010101000000000101001000010100100110010010000000011000100000000011000011000100000101000001010
00000010111100000010001001011000101100000000110101011000000011010011100110011010110010100000000000110
00010100001110100100001001011010001100010101101000001110010000101101001110001000010000000001011101010
01110010000001000000001000100000000101101010001101001001100000110000001100000000000100011000010100001
00001000000010101000001000000110001010011010110000000000000001011000000001000001001101001100000001101
00010000101001100100100001000000010000110100000010110110100000010100011010101000100010100000101011010
00010000001000000000110010110101001100000010000001010101010000010100100010010010101000010010011010100
00000100100110100000000110000000110010000001000000100000010000000000000000000011000000100011000000100
11000110100010000111010000001001000100000000000001001000000010110001000000000010100100100110010011111
10001101000001010001000100100000000010000000000011000010000100001001000001000010100000010000101010000
01011000010000000100000101111100000110010010000110100000000000100000000000010000010001100000000010001
00001010111000011101001101101001011110011000010000010000000000110000011100010010100000000011001011000
01001000000011000100100101000101100010000000000110000100010010000000000000000110000010110000000000111
00100110010100001000000000000101010010110000110010000100111001000000010010010000000000101010000100100
00010001000000000001000000010000110111001001010001000000000000001100001000101000110000001000000001110
10010011011001001000010100110101010010110000110100100010000000011001001101000001010001100011001010000
10000000000000110001001100001000101000010100100001000100010010100000100100011000101011101101000100000
11000010110100110110010111000001001101010000100101000010000000111010000001010000001000000111000010000
00001100110101101010001101100000100000000110110100001000101110001001010100000000000100011000101000101
00010000110100111000100100110011110001100001001011100000100101010000100000000000001100100000011010000
00101000000100100001110000010101000001000000000000010001110000100010010011010010000010100001010000000
10101000001000000000011000011000000000100101000001001100000100000000000000000001000000110000011100100
00000000001100100001001111010010000000000000000101010001000011001100001000100000000001111000000000000
00000010100101000000010001100010011011101000000000010000110010101001001000100000010000001001000100000
01010000100001001000101110000000010000000000000000000100000010001000100001000010101001011010001000100
00000001111011000001100100010000110000110110001000011011000100001000001000110010000001000100111000110
10000011001000010000000100010000010110110010011001001001001001101101000100000010110000001000001111100
00000000000000011100000000000000000010000010000011110000001010000001101000100100100010100100001101100
11001100100110000001100010101000001110000000101000011010000100011010101011011000000100000000000100010
01010101000000000001001000011001001010000010000001001000011010100101000001000001000110101100010000010
10100100001001001011010010001011010000000000010000000011011100010100110100001100001000010110100101100
11000100101001000000000011010000011000000000010000101000001010010000010000001101001001100101010001111
00000000001110000000100010100010000000010110000000110000001101001010101001000101011010000000100110010
01010101000010010111110000110010100000000000000101100100001000001000011010100000000110010001010010001
00110001100100000001000011000100011011001001111001010111001010000000010000011101000011000010011000101
00100001110000100010000100000000011100100001001000001000010100001100111000110001001110000000011100100
11000011100000000101001001000110011001000111011000111000000110010000011100101010001101000110110011110
01100000010000101000000010000010100000001110111100110111010100000100100001010101100000100000000010000
00000000011011100000001001110000001000000000001011001001111001010000001001011000000000001001100010001
