01001001000000000011010001100110101100000100000001100100000000000011000101101010101100001011000001001
00001000000101000010010010110010000011011001100010001100000100111000000100111011001000001000010011010
00001000010000000010010000001000111000110000100001001000100000000100100100001000000000111101001000000
01001101000010001000000001010010010010110000100000001101000001001000001100011000001110001000000000100
00000001000001011010110100000010010000010000000000010001000000100000100000000001101000000101101000000
10100001000110011010100001001000000010000111000000010000000000000001001000100010011000000100000101100
00000010100100100001100000100100001110000110010011000110010000001110000000000101001100100100010001010
00000010000000111010000000000000000001010111101001001000010100000011000100101110000000000000000100100
01000001000100101110000110011000000100000001000001010010001000000100001100000000010010110000010100001
00000001000001000100000000100000000110010100101100101000000100011110010100110010000000010101000100000
11010000110001001000100001000100100010010001100000000010010001100000000001100000100010011010000000000
00100100001100010000001001011110100011001110000010111101100001000001000010001100000010010010000010100
00010010100001000000001101000110110000100010000100000000000100010000100100011010000100001011000110000
01100111000010100010001000011000000010001010010010110011000001101010011100000100010000000010110001010
01000110000001100000000111000000101110101001000010100110001001101010000000000000010100010011100010001
00110100000110101000000111010000100011001001010100100010000101000100000011010000010010110000010100010
10000010000001000100000100010110110000000000001101001001001000000000010001101000010000100100000100100
10110100100000110000100100101001000110101100000000111001011011000000000010000000000100010000001001000
01011000000111110000110000000100000001000000000100101000010000010110011100000101001000110010010011010
00000011010100000001100010010001001100110000001100000110001000011000010000000000000010011110000010001
00010110000000001100000010010111000000110000000010110001001100110000000000011011010011000000101010000
01000001000010000111011001110100011000001001001100110011100010101101000000001000100000010010010001000
01010000101100000010110100010010000001001001100011101100000010010100010000000001001101101100011001000
00000101001000000001010100100000100100000100010100000111010011100011000010101000000000100000000010010
01111000000100000110001000010010110101001001000011000000100110110011001100110000000000101100000001010
10100000110000001000000111011011010110110010111101100000110010011000100010000000000111110011100100000
00110100010001101001000010001001000000101000100000000000000010001000010000010010000101100011110110100
00011010000101110111001000000010001000000101000100010000100100011000010100100000101011111101000011101
10000011100011001100010100000000010001000100110001100100110100010001000011001001011001000111001101100
01010010000000010010000000100110001010100000000000010100010000100001010110100000100010011000000000000
01000000101101110000001100010110001110000010001111001000000000011000100110100001000001110010110000110
00010001010000000011001011000000010001000011100100011010000000010101001000100101000011110000001001001
10011000010100010000000001000010000100100010011100010111000000110100100110110010000111100100101100100
01101010000000001100101000011110000000000000000110100101000000100001000000000100011001000001000011010
00000000000110000000000000110000000010101000010011010000110100000001100100000001100000100110110100111
00011000100011001000001010110010100001111011000100000001010001001011100100010100100010000101000000010
00000010001110111000000010000000001000001000010000000000000001100001100000000000100100001010000100000
11110000000000011000000000100011010001000100000101110011001100110010010010010000010000010110010100100
01000000010100001011000011000000101010000000000001001000100111000000000010000000000000010000111110000
00000000000101110011000000011110000000000110000100011000100110101010100010000000000100010000010001000
00010000011000011100000001110000100000000000000011011110100011100000000000001011010000110000100010110
10001100101000100001010001001101100000000101000110011010011101000101001000101000110011001000010100000
00010101001010001101000001000000000010010000001010100101000011001000001010010001100000000101110110100
10011001111000000100000010000000000100000001100100000001100000100000001001011100010011100000101010000
01100110110001000000000000011001101001000000001000110001011110100100010011001010100000000101000000000
10100000001001000101000000101010011101010101110000000101000000000001100000001011010010110101000000001
10011000101100110100000110000000011010001111000000010111001100001000000101110101110000000010110001001
01000001011010010100000011000000110000000010101001100000010100100011100010001010001000100000100100100
01100110000010000000001000100000000001000000000000101100001010001000000001010101000000000010000110001
10000100000101010100000100011000101000100100100101100001010010001010001001000000000000111000000110001
00001000000000001101101000101010001000000000001000001001000101000010110001100110011000000000010000000
10000000011000010101101000011111110011001000000000000001000000000000000000101010000011010011001010110
00111001101010100100000000001001000000000011000000100001010100001001101001100101100010000011001010010
01001010000100000100111000001000001001100000010000000000000100000000100011000011000111100000100010101
00110000001100100010001011000000010100001001000000000101010001001000110000011000001010000000100000111
01101100000001000110110100000101000001100001011000011010000000100100100000001100101001101000110000101
00011100010011101100100000000011001010000110100110000001010011001001000010011000000000001010000001000
00001110010010110001110010001001000001000000001000000000100000111010000100000000110100000010100111001
00000100001011101000010001100010000000011100011011000000001010000011000000001010000111011000001100010
01001001001100010010011000001100000100001001000000010001000110001000001000010011001011101111010000000
01000011001000000001011110000010000001010000000000100010100000100000100000010100100000100011110000010
00000100001000110011000000010011000001010000100000011000010000001100000000000011001100011001000000001
10000000000000000100100010110000000000010011110010000101000000010100000101100110010000000011010000001
00000010000100000000001110000100000000001101001001100110011010000110000100111110100000000001110000100
10000001000001000000001000100000011000101100000000001100000000100001101000100000000100000101011001100
00100100100100001100000100000101000000110011010101000010100111100011010000010000000000001101001001010
00100001001110000010110100110000110000000010001101111010100010010000110011100010001111000000001001100
00000001000000001000000000001011000100001000110001001010001000101000000010111101001100000101010000010
00000111011100000000101101000000000000000001000000100011111010000000000010100000000000101101000011001
00001001001000000011001010000101000010010111100000100110000000000000000011001010101010110100010001000
00000001010100100000000101100100001000000000100010100010000001001000001101001000000100100000000100100
11000001000011000000000000100100010011010000001011000010010001010011010000001010001101000000111000010
01000000000101000000001000000000101001000010000100010101000000101010010000101000000000000101100000101
00100010101001001000000000010010010101001010000111000001100000010010110111101001000001010001000111000
10100000100000010010001101010000010000010000101110000110000000100001010100000000110001000000000110100
00001000100111000010101010000010110000000000001000000001010000001000011001110000001000011000001000100
01100000000111000001000100100010001000000000000000000100000000010101110000000101001000000000011010000
10011000000101111111100010000001101000010110010111001000010001100011010001011000010010000100000010010
00100010011000010000110110011010100001011101101000010011000001110000000001000010000111010100000001000
00100101000100000000000000000001010001101000100001011011101000001000000011101101000000010000101001000
00110011010000001111010000001000000000100001010010000001100000100000100001000000000000010100001111111
01110010001001001110100101010010000100000100000000000000000000000001010001000100010000100000010000100
10001000001010011100100100100000000000001001010110110000000110010011111100010001100010010100010101011
00101000100001000010001110000001100101010001111100100010110111001000101000001000001000111000010000000
00001000000100001000100101000000000100000011000000001111110100000000100101100100110101011001010001100
00000110000010000010100011011110001001100101100000101010100110000000000010111000100000101011011111000
01100000000010001110000000010011000000110000111001010101000001000100011110111000000000000011001000001
11001000000000001011000000000000001000011000000100010010100000111000000100100010000100000000100011000
01000001010011000000010001000101000001100101000001001000010111100000010101111000111100100000000000011
00100111001000000010010000010111001100100000000111001000100010110100010000100110000101100110000000001
10101000000001111110010000101000001000100011101000010100001100010000110000011111010010000100101011001
10101000000111010000000011110100000001001101100000001010011000001010010000000011011000000001100000000
01111001010101000000111000101010100000101000100001000010011010010010111110100001000010000000110010000
00000010000101100011000010110000100000011110000100001010000000010000101000101100110000001001010000110
00010000001100100010010010001100000010000000011000010000111000000110110110100110001001100011100001100
00001100001010000010000011000000111110110001000100101000010110000010001000011100111000000001000101000
00001000000111011000000011010101010100010101100100100101001100111100000111100010001000101011010100101
01000100100010000000011001101111000010100100110100110110001000000000000000110001001000100010010001000
11000000100001000100000100000000000100010000100000110100101000001101000001000010011010100010000001000
00110011110000010100001000000110001000100010001101010011010100110101101000010001100010001000000000111
00100010001101101100000000100000000000110100000010011010001000100100001100000000111100000001000100001
