00001010010001100001110011000101001000101000101100100000011100000000000000001101000000101001110000000
00000101111100000111100001000000100011100100100000000000011001000100000100100011001010101100110000001
00001111001101010010010010111110001010000000010000000000010100001100010010001001011100010100000100100
00110000001010011000000000001001001011000010101101010000001000000000101000001111101100000000100110100
00110000000011010001001010000000000010110010000000100010101110110011000100011010000000011010000110110
00001100001000000000011000111011000110000000010010101001000000000100010000011001111000000010001010011
00000000110001000110000010111001100000001100000000100011000010101000010000001000001000110000000100000
00100001000000000110100000000010010100010001001011110101000001010000000010000100100011000000001010101
00000010010001101010000010000110101001010000000011010000000010000101000001100110101100000010001010010
01001011000000000100110000000011100010101001100000011000001000000011100100100010000110110000101000001
00000111110001100000001000101101001110000010011000100100010001110000000111110100000000010110001001011
11000000110010000010100000011110000010000100001011100001100010000000010000000010001110100010000101000
10001000000100000011101001000010010010001001100000000000100110110001100000111000010000100100010001010
00000100100100100001000011100001000100001111010011101000100000000000110000000000001100001000100000110
00100100000000011100010100000110000100010000101100000001100000111000111011100000011010101101100000000
01000000000101000000001011110111101001000100000000100000100101110000001010011010001010000000000001110
00000011000110101111000000001000000011100000101101001011000000010001001100010000100011101001100000010
00101000010000101111001010100001100011000100110000000000001000000000000000000111010001011001000000001
00001000000110010010001000101111000011000001010011000011000000010011000011000000011000100011001000110
00010100000001010100001001000100011000100000100001000000000000010000000110000000000000011100011100000
00000000000011000100000100000101000000100010010000010100101000100000100110000000000100001001000101111
11110000000001001100000001110000101000000011110010000110011000001100000000000010010010000001000110000
00011000001010001100010100010000001010100000010001011000001001001110110111000000100000001000111000110
00100001000000000000101011000001111100101000000000000000100001001100010010100000100000110100000100101
00110000100011100001001001000000110001000100000000010110100010101111010010000010000000000000100000000
10100011000100011000000010111000100001100001000110010010000001101000001000001110000000001001000010100
00100001000001001000001001001011000000000001000000001000010000000010001000010000000101101000101101000
00010011010001100011100110000110010001001010100000100000001100000000000010000000011001100001000000011
01000001100000010011100000010001001001000100000100000000101100000010110010000000011000000000010001010
00111100101100100111111000010000000101000000010000110000010000010000011100010110000100001101100011010
00100000010000001101011010010111001110010000000010000010111001011110010100001111010000100001001110000
10011010011001001110000100000000100001000011100010100000010011010001110000110110000000100100100001000
11101100010000001110011111000100000000000010011110010000000100110111000010100001011101100000100000010
00011011000011101000101110100100100000010000001001100100000010000000010001100000010011100101000111010
00001000001100100110001001101000000001000010111010100111100100000010100000000100000110000001000010011
00000001001000100010011101110101001000001001100000000001100100000000000000000101011000000101001000000
11000010000001101000000010010011110100000011001110000101110100110000001101010100101000000101000001000
10100001110100011000101101001010110110110010010011000110000110100011000100101010000010100011111010000
00010111011000010010000001010000000000011000000000000010010000100010001011000001000010010000000100000
10100100001000000100000100000000000100000010000001100000100000001101000001101000100000100110101010010
01001101101111001100100011100100000000010100100001001001000000001001111001101011000000110000101010000
01010000101101100000010111001000100000000001100111000000010000000010000110001000011100100000000010010
00001110000000010000011011001000000000101001010001100111100000101000000001010000001010010000110000000
00101000000010100010000000001000011100010100010011101001011010010000011101000010010001001000100100100
11100000001000010100101010000001000000100011000100100011111000100000011001001000000001110000000001000
00011010001010110010100001010000010001000010000001000010000100000011010000110000001000101110000100111
11110100000001100111100101000000000000000011101110100100101001010000010000001011010010010011000100010
00110011110000000101000000000010000101000010001000011010110001010010110111001000000010100010010010100
10000000101001010010110010000001101001000000100110000001111100000001101001000000000001001001111001100
00001010010000001000011000010000011000101010001000000000011110010000000000000000001001000000010001010
00010100100010001000000010001000110000000010000010010011011000000100001010010100010110011000111000101
10000100011000000100001000000110010101000000011000000001101000001101000001000000100010101000001000110
00001101000010110000101010001110001110001010000001001000001100001011001100100010000100000010101000000
10010011101100000101000111100010111001100000001011111100000000010101000000110000001010101000010000110
00000001010000010101001101000100100011100010001001000111100111001000010101010010011010010000001000000
01000101100000010001110011000010010001110010011000101000001111010000011010100110011010001100000001001
01000101101100100000000000111000110100110100010000001100011000110000101001101010010000010001011000100
00000000000000001010101111111111010101100000000100110001000000000000000001110011011000010010100000001
00100111000000000001100000011100000110001010100010000001110001010101000100010000000000000000000100000
01010001100101000000000000010000001100001000010100000100001000010100000110111000000010010010000010001
00001000100010001001101010000101000000001101000000000100000000111000110000011101100000010000000000111
00010000010000101000000100100001101001111011101000100000100000010100010001010101011100000001110010100
10000101000110010001100100111011111000010010000001001010101000010110000111010000000001000110111000111
00000001100000000010100000000001010010000000011000000000000000001001010001000101100100011111001000000
00000001000110100011110000000000101000001000101000001000001001000001011000111010000000010011000001010
11100110001110111000010011000011100100100001111010000101000000001100001000001000001001110001000001000
10101100000001000101000000100000010111100100000000100100010101010001000000000000010010101011011001000
10000100000101010100000001100100000000000110000011111100000101000011000000100100001010000100000000000
01100011100010100000010100100001000001001010000000000001000001000000011101001000000001011101100000000
00010100000011000110000000000010100011001000010000100000100010111001100010000001000010101101000010000
00010110100001101100100110011000010011010111001101100100000000001001010100110011101000110011100000011
01001001000010011110000010111100100011101101010101000000011000000001101100101000111000101000100010000
00111000000000100000101001000101001001000000010001000010000000010000000100000000101110100000100010100
00010000000101010110101100000000000000000100000001010011100100101010000001001000101100001101011000000
11001011001100100000000000100100010100000000000000111000010001010001110001011010111000101101011010100
00000000001101101000011100000010000011111010000110000000001110100110000001111000101000001101000011000
00100100000010001100001001000010001101000000000000001010000000000101010000110001010011001010000000000
01101001010000000000000010010110001100000110101011101101000001000000010010001100010000100110101100110
01101000010001000101000110000000011110110101101000001000010101001001001000001010000000001000100000010
00000000010000001000000000000110011101010000000010101010011010100010001110111010000001101000011010110
00011111001000000000001001110000000101010000010000101000001010011000000110001000010010011011000001000
00100100000000100000001110011001010011000111001001101011000001000110111001010000010111000011000010000
10010010000000000010000110000010001100000010101100000101001001011100000001000011101011100000111001000
00010110001101001001000110100000101010011110000000111000001100001001100000100110100111010000010000010
00110101100001000001100101010010000000000100010010001110110000001100011110001000010001010110000111001
10100001011101001000000000010010001110000100101011000010101000001100001010100001000000000000011001000
00111001100111110000110010000000010000000000000000000100110000000000001100100000010000100000001111100
10001000000001001110001000000000010000101000000001010100111011011000101110001100001000000010101010010
00001001001000000011100000100000010101000000000101000100000100010100000010001000100001010010001101000
00000110001010000000001010100000000000000001000100000000010110000000100001100010000100000000000000001
11000000011100100000000100110000000001001000100100011011000100000110011000010101000000000000010010000
00010000000000010011110001010000000000011110000000001100101101001000011000100000010000110010000100011
00000001010001110000000000000111001100000000100000001001000101010000000010011001100001001100100000010
01010011100100000011101100001111010001000100010000100000000110001100000010001001100001011000100011000
10100100010110011100110001000000000000001010010010000110001000100000100001010100001111000000000110100
01010000101101001010000000000100010100000001000000000100000000010000000100000000000001110010101100010
10100001001001101000010100000000000000000000100000111010000001000000000100000001000000010000010100101
00001001001000001001010010010000001100101000010000011100001001001011110000010011010000000010000001000
00001100000000010100101101000000100000000011000001000000101000110000000100100001100000000110100000000
10000000110100011100100010001010110000000101010110010000001101110000001000000100100100001100000000000
01000001100000001010010010001110101000101001000000101010000101001000110100110000110011101100001000010
