00110011010100001100000001000000010000001000000010110000000000010011101100110100000100110001000010000
00000010101110010110010110100110000000001101011001001000110010010010001111000010000000000010000010100
00000001000001001100110001000110010010100000000100100000110000010000001101001000010010000011101001100
00010110110100001101000101110000110011100000000110000011000100001000010001000001010000000011001000011
00000000000110110100000000001000011010000011110010101001000000100000101010000100011110010010001000011
00000110001100011101000001010000000000000011110101010110001110000010010000010100011001011001100000000
01000000010100100000110001110000001101101000000001011000100110100010010010011100010000111110000000000
10001100000010010000010001000100110000100011001000000000100110000001011000000000100000100100110010000
01000101000101000000000000000001000100000001000100101100100000010100000000101010111000001100000000001
00111000110100001000001011000100000100000110010001000000010110010000010000001110001101000101000001011
10001100000011100001001000101000100000010001010010000010010001100000000000000100010110110100010100000
10101000010100001001000101010000001011101101110000001110011000010011010010110000010110110000101100101
00000011001000000100100000101001110011001001010110001010000000000000001110111000000010001000010000110
10001010011001000000000100000010011011100100000001100000000000100000000100010000000010001000001000111
01101101000111000000000100010110001100101010110010100100101001001011100110011101010000010000011110111
00001000000010000111011010100010000000000100000000010000000001001000111100000001111010100000001110111
00110100000100000000100100010111010010111000011001000110000000000100101101100110001000010100101000001
01010010000000001000000010010000000000001101000000100010001001000001000010010100000000000000000001010
01011101100110000001100010001010110001001001100111000111011000011010001011000000110100010001000000001
00101000000000010000011100111000100000001001000110011000011000010010000110001101101101101000000100011
00100001000011010000001000000000111100010000101001000001111100000000000001001000110010001001000001000
00101000100100011000100000000111000110000010000000100000000000010000001100010001000010100000010011101
10000111011001001000100010100100000010000011000011100101110011000000011101000110001100010000101000111
01000000110100000001000000000010000100110111010000000110000001000000010000000100001001000000100010001
00010000000111101101000011110000000001000100001001000000010100010100111101000000000110001001000000100
11000001010001000110000010010000000010110100010000010100000110001000000001001000010100000001000101110
00010100000001000001110010010000001110111001100000000000000001000010101111000010010000110110100000100
10010001000000101101000100100001100100000100000010101001100010010000000011001100000110010001001001001
10110011001010000000001010101000000000010110100100101001011000000100110001010100000000000110000110100
01011001101010000100000101010000001011010001010111000111011101100011000000100001100000100101010011000
11101000000000010001101000000000010010000000000010000011101100010100101111010100010001001010111100010
01110000010010100110010001000000101000000010001010011101000000010000110100110000001000100000001010010
00010001001001100010100010010001001101001001000110000110000100000000010000100010000101110110110011000
00110000000000010100101000000000010110100000000001001000000000011110000001100100100000010100100011001
10100110010001000011100000010010010100100100110000011000110010100100100000011000000000010100001001000
10100100000010010000100010000100100011000000100000110010100000000000000001000000100100000001010010000
00001000101010100001100100010000000001010000000101000001000101000010101000001001100000010110010000000
01001000000101100011001101011001110000000101001110110000010010100011100001010001011110001000110110000
00100001010011001100100000000011010010100000010000010000000001000001101010000000000000010001011000000
10010110111100100011000101000010100001100101100011010001101101100100000000100000101001001001000000000
01010000010000000000000000000110010101000101000001000000110000110000110000000000100000111010010100110
01010110100011000100100001010000101010000010110010000000101010010100011000010000100000000001110000100
01010000000000010100001010001101000010000100000010011000010100000110010000011100011000001010101000000
00100001100110110100000000000100011000000010010000000010010010001101000010000000111000010111001011000
00100001010010000001000010000101110001000000000110000001110101010001101000010110100100110001000100100
00010001100010001100001000000101100001010100101010110000010011010000010000101010000110110000001100111
00000001100001000110010000100001000111101100110010110001001001000110000000101000101000100100001110000
00100010001000001111000010010101001000100101100000000000000000110000010100000010001101001100111001110
10000100000001100000011000000100000000110100110010000011001111001001010000011011110001001010000000100
11001100011011000010000110001011011011000010100000101101010001000100101000110101001001000001001100000
00011011110001000000000000001000000000100000110000010001000100011100000001000000100010010000110000000
01000000101100001000010100100011101000101110001100000000000010000110010010011010011000001001001110001
00010000111000110100000000101001010110000001010011000100000000000110000001011011001010010100100011001
10000010000100011001110010001000101100000001010011000000001010000101100000100001011001000011000110011
00111011001110000110010111001000000010010011010110000001100000001000001000001000011100000110110000010
00000001010010000000010000000000010000001001001000101000010110010000000010101000010001100110000000000
01010110100010100000010000001011110010100001011010100010010001000010000001010011000001010000101000011
00000000000000100100000100111110110110001010101101100000111010100000011010101110000010000100000110000
01110010100000000011110000000001010110000000010000010110000100000110110100001000100001000100001010001
01000000000111010000001111001101001001000000001011001000000001000000100000100101010001000111101000000
00000100001000100000001010000110000000010010000000101100010001110111000000100000001000101011000000100
10011110110100101010000101100100000010010000100000001100011000000000000100100000000000001101000100010
11100000000000011001000000000000010000101000000000110011101000110000001000000100100001000000110010000
00010000101010010000100010100100010111010000000010011001000010010100001000011110010101100100000000101
00011000110100010100011101011001000100100100000000000001101101001010001100010000001000001000101000001
10010001010100000000000000101010000010000010000100001001000100010000101100100100000100110000000000000
01000000000001110101001110010000011000110001101001000001100110010100000010000001010100001000000001000
10001010000010000000000000001010101010001110000000110000000111000001000000101000101000000000101111001
10110000010000001000001100011000000100010001010010010011100011000011000011010010000001100000100001010
01010000000100000101010100000000100000100010110101000010000101010100001010101000011001000101010010100
11100000001001000000101001000010101000110000011000010011000000000000010000010000000000000011000010010
00100001000001000011000011100100000001000000000010001100101000001100000001000100100100001101000000000
01000100000010000010001010000000010001111001000100000011011000000111000000101101001000010000101101110
00000000100011000101000000011000001100011000000110010101000000101000011010010001100111011000011100010
00010010100010010000000010000000000101101001010010000000000000110001000000000000101000101000001101001
00011100100100000000100000110110000001101100010000100001000000010011000010010100000000100010000110000
00110100101000101011000011000000000100000010010010000110001000000011111001100101000001000101110000000
11000100000100000001101000100100011000011000000000100100111100001001000010010100000101110000000000000
00010000011011100100010000000010000000010100000100011100000010110001001100100110010011000000010100000
10010010001010001011000000101010011000111100000000000010001101011000010000010000001000000100100000010
00111001001001000010011001110100010100000100101010001000100000100010110100000001110000100010000100000
00001000110000010000000010000100100000101011100100000101000110000000000001000100000000000000101111100
01001110000010000001000000000110000000000001111010011100001110010000101001100000100100011100010100000
10001010000101000000001000100111001001110001011000010010001011000000001000100011010000011000000100000
00000001000001101000001000100010000110000001010100000001010001100100100010000010001001011010001000101
10110000000000000000100010001101001000011111011111001000000000100001000000000001110000000000000011010
00010000110100010101100100101100110011010001100100101010010100000111001001101000011000000110001001111
10000100001010110000100000100000011100000010101000010100001010010000000010100000001001001011000100101
00110000000001010100100000000001011000010100110000100001000001000111000000101100101010000001001000000
00000000101000011010101000101010011001010010010100000011001110000100011001100011000000100000111000101
10110100100000000011010000010000001000000000101100011001000011101111000010010000001100000000001110010
10000000011000111111000000001011001001011000010101000000110011101000000110000101000000001010010011000
11001010000000000100000000111001011000001011110000000010000010001110011000000101000001110010100000101
11000000000010000001000000001100100000000010110001100000100100111110110010100101000101010000100000000
01000000000100100000011000101001011000000000110001001000001001110000100000000010010010001010010100001
00010000110000000000000010110100010100000000000000010011010100001000100001010101000111000101000011001
01000000000010010000111000100100011001000000111010000000000001000100000010001100000000110000000001101
00011100100000000000101100101000001100011010000101001001000010001100000111000000000100101000101001000
00011001011010100110001111001001000000100111011100001000001000001010000010110001000001000011100000100
00000000000100010000110101000011010010000000001000000100000001001111000110001000010010100100000001000
00100000011000001000010111101011111000010000100100011011100010101001000001110001001000010000001000000
