01010101011101011000011010010000001010000110100000011001001000001010000010111011000110100000101000010
00000100000100000001000011101000000100100101011010100000110000001101100011101011000010101000000100111
10100010000000101010011000011110000101000100010010101000100000100011001001010100100010010001010010000
00001010000100011011101101000010000001010000100011000000010000001100000000010000100000011011011011000
00011111011100011101000100001100110001000010000100010100000101111000001000000000010000000110000111000
00000001010000110010010000110000101000110101100000000000000001110100000001111110011000100000100110110
01010101010001001010001110010000000000101000100001010001011100100110001000101000100000011001100111011
00100000000001001010000111000010110010000001010001010000010010000010111000000101010001001101100000000
00101000101000001000000010000100000010010100110000000000100100000000110001001000001010000010000000011
00001000100000100111010011010100100000101010001000000011000100000000100000000100000000000011100110000
00100000001010010000001000110001000000000111001101000000000001010000100001110000100100011100000001001
00001010001000100100000100111000000000000100000101000100010001011100000010111010100001001000110000000
00111100010010010100100000000001001000000011011000100101000000000100100111001100000010111000010001110
10010001010001110010010000100100000110110000010000000101001100110000111001111010100001010100000010000
10000010101000000011000010000010000100100000011010100001100100001101111101110001010001000101000000001
10001000010000100001011010101010100010011000001001000001010000000010000000000110100101101000001100000
00010000000101000000000001000001000000001110100000001110000110011000101000001010010011000000001100000
11010000001000110001000011001000010100000000000000000101101000100000000001011000100000010000000010011
00000010000000010001000101100001000100000000110100100110000000111000000000011010001000000000000100001
10010100010100000001010001001000000001100000000000100000010110100100000100001000000100000110000010000
11100010000011101100011000010010010000000000100000110001000000001001000000011101001010010001011010001
01001110111000001000100000000000010001111001001010010001100100010000011010101000001000001000110100001
00001000100011001001011010001111001001100110001011100100000001000110010000011100101100100000001000000
11001000100010111101000100011001000010001101010001110000110001001101100000000010000000001001000001001
00000000001000000000001001000001100010010010000000000000001001000010001001110100010001000100100010010
00001001010100100000000000010010011110011000010000000100001111000000000001010100001000010001110110000
00010111010000000001100001011000000000101000100000100010110000111011100100000001001001000010000000000
10001000100101010000100010101001010000100001100000100001000100100000110001100001100000001000101000010
01011100000001110100010000101001000000101010001001010010000001110001011100101000010000000011000001000
01100000001110100001000110001001000100000010010010100001110010010110100001010010010010100000000011101
00100000100001101100010010001101000000000010110000001110000000010000100110001000001101010101000000010
00011100010001100100101111001000000000000000001101011110000000000101001010000000001111010100010100100
10000000010010111001000101010001000010000010010100110000001010101101100010110000111100101100000100101
00000010101001010100000000000000001100110010100110001001000001011010101000000000001100000010000000011
11110000001000111100001100010100100110101111000100001001000010010100000110110001010001000100101000111
00000001001100000001100100100011110011000000001000100100000001110111101010000000000001001000000000000
00000000000011000000001000101100111000000001100010000011000000100010001000010001100000110000101001000
01010100001000000000001000001000100000100101100101000000111001110010101000000000101110001001000000000
10110000000010100100000001000110110100001001000000000100100000000000000001100000000100010110000000011
00001011001000000000001000010000010101011010001010110101001000001000011001000010011001100000001000001
10000001100000000000001010111110110000000000100101000111000000011110000001100000100000101100001000000
00000101000010010001001101011000010000011101010110111110001000000000010010010000010100000000010000000
00011100000001010110000000010010000101000110000000110000000001000001000000001100101011000000000000100
00100000110011000000010010000001110010100000100110000000111000100111000011000000001000000000011010101
00001101101011101011001000101000110000000100000001110010010100010000000000001001100101001010101000000
10001110001100000100000101011111100100000110001001011000001000011111000010000000000011001010010101111
00010110000111001001010010001010100001100000010000000000000000000110000111101101001111100100000001000
00100110000100000110011100000000011000001001111000010000000000001000000101100001000000010000110000000
00001101000101000011100000000110101011000010001001011000000101000001110001000100010110000000001000100
00111000100101111000010000110100000010000000111100000011100001000000001111000010100000000000000010100
01011100000010010100110001001000000010101000100001000000000000011010100010010000000010010001010100001
01010000001110011001001000010000110100000100000010000010110000010000000000000000000000000110000000100
11001101100010000100110001101100000010010000011000100010000111001100100110001000000000001001000010010
00110001000000110001100110010011101110000100000100000111000100011000000001111100000100100101010110001
10001000000001000011100011000001110111001000000010011000000000000001010000000001011000000011001000100
00100010000000000000000000000001100000000110000010110101100101011100010110000011000001000000101000011
11000001100010100001000000101010000000010010010000000000010001010110101010000001001010100010101101000
00000010110101010000010101101100000000001110001000000000001100000100110101000010000100001000000001001
00001101100000100110011001000101100000010010000010000111001001000001000000010000000011010010001000000
00110001000010110000000100000001000100011001011000001110100110000000100001100000010101101100001001010
10010000010111110000010010000010000110011011010001100010000010010000001011000000011010000010001010000
01000000000010101110101100000001001000000001010000000010100001100111100000000010001000000011100011100
00011000000110000001000000001011110000001100110000001000000000010010001110111001000010000100010011000
00010000000010010011001000010001100110001001000100011000101010011001001110111001110100000100100000011
00100001000010000110010010000101000000010000000000100000000000000011001000000101000000000000110000110
10111101001110000111011011110011000010001110001001000000011010110000000000010001000100010010001000011
01100000010001100101000101010110110100100101011000000000100011111000101100000011110001100000111010101
00001000110011000000100100010101001111000110000011000101000100000001000000010000010000000000100110000
00111010100111010010000100001101110011000010100000001101000000100000100000011000011110101010011000000
11010010100001000010000100000010100100000110100101101010000000110100000010001100000101010000000100001
10101100000001100000011100000100000000000000110000000001001100001000000001000000010010000100000010001
01010110000111100111000000010000001000010000101000100000010010110010110100101000001010110000000000101
10000000000001001000000111100000101010011000010101010000000000001001010000000001100000001110100100000
00000011000000010000000010001101000100011100001001100000100000011100110000010110011101100110100101011
11010001001010100011110000111100101011111001011101100000110000100101100000101000110000001001011010110
00001110000100101100001011110110110000000001010010101001100010100001011000001000111101001010000000100
00000010101110000000000000001010101011010000111001001001001101000001001000010100000000010001000100110
00000100000000110100010001100010100010001010010001110101000000011000010001001000100000111100110010001
01001000010100001110001010010011101001000100000100000000000110110000000110000100000010100101000110010
01101001000000101110010000000000011011010000000001101001010110000010000001001000011011110100001000101
00000110101010010100010010000100001000010001000010110000000000000010000100011010001110000010000000100
10001100000010100000001101000100011000010011000010000000001010010010010100101010010010010111000001000
00000100000000101100010000100010000001000101000000000001101000100000000001010100001000101000010011101
11010100101001110010000011010010010000100101000011101011010001101100010000000110111101101000000000010
01000010001000000010110000110001001100100111011010100001011001000011100010010010000000100110001010110
10011010110100100101010101010000001000000010000010100000100100100100010000110101001000010100000000000
01000001110111010001000010100001000110000010101000000001101010100000011110000100010010101000011010000
01110100000010001101000010010000001100001110000010110100000000001010100001110000100001110000110100011
00000000101000001101000000000100000001000010010001110100001000100001011101001010010000100010110001000
10101011101000000001000000001000001101000001000000001000001001100101010001000001000101010001000010101
01011000001001000100000100001010000000101100001000110100000000001011010111101000001100000001000101010
00101000000011000010010000110000100010101001000101001001000010010010001000100000110000011001000010010
00110001100001010100110100100001100000000000110001100000000001001100101000001100010011011000001100000
01010001000000000000000110001001101000001000110100100000110100100001100100000100000100010010100000100
00100111011000011100000000001100000100010001100010000100000001110100000101001000100000000110100000100
11000001000110111010001100100010101100000000001000101110000001010101101001000011010000010011100001000
00000100000011110101001001010000010000110010101000101000011110000000000001101000111011010000000110010
01000000010111000011001010110001100001011010001011000000000011101011111010000000100100000101000011001
00010100000100110110001010011100000000100100001001011000000001000010100000000110000100000010111001110
01101000000000000000000110101100001001011000011110011010010000011010010101001001000000000100000100110
01101000010010000000101000100100000010011000010000000010001111010100000010010000100100010000100100000
