00110110000010000000010001110101011000100100011000010001000100011001100000001010100111001000010111001
10000110010010110001101000000011000000001000000001111101000111001000000110101001110011001001010110000
00000101100100010110010000010010000000001000000001000100101110000000000100010101000001100010100010000
10000100000000000101011001010100101110011010000000011111000011000100000000010000000111010111000010000
00110011000001000101001011100110101100010000100010000000001000000000000101000010011011111101110001100
11000000111010000001000011010000000101010100100000001110100100000011010100010010000100000010000100010
10100010100001000100000001000011110100001100010000001000000100110000000100000011001000000100100000001
00100000000100001000000101000001010000001110000010001001110100001000000100101010111101001000001000000
00100111100000001110101100001100000000000010000110110000010100000110010111010010000000100011101010010
00000001001001000000100110010110100001001010010100000000110000011001111001000010000100001000000011001
00000010011011010010010101010001010001110010010011000001110000010010000111010000101011101000010110100
00001000100101110110001101000000011100011000000001000000010000000000000111101100000010111100100000010
00010000110011010010101010000001100101001001010001100000100011001101110010010001010000000111101000001
01010000000100001001100000001110010101001000010000000000000010000010001101000011111010011100111011001
11000000000101000000000001000010100111000001111011011000000100111001000100101001000010000010000000011
00100101000100000100100010100001110100010000100010110000000000001000000010100001010000011000110001000
10000010101011010001001000100000001000000010100100101010100110000010000011101101100100011010000000100
00001000000100000000000010000000010010000001000011011000001100100001101000000000100000010110001001010
00010100100110000111000000000100001000110111000000000000110000100100000111011111001001010000000011000
00010010101000010000000000110100000000010000100010001000100001110101100100011011000111000101000001100
00101000000101010000000000000001010000000001100100000010000100011010001101001100000111001010000100110
11100101010000010001111000001000010000010100000000101100001000000000000000000000111101000000100100010
10000111010000111000010111000000100000000100001000000000001010100111100000001000000100000010000000100
00000100010010001010101011001101000100010100000000110000001001101100001010010110010000000001000101001
00010000110010111100000000001100010000010000100000000001010111101100111001000111011011001100010010010
01000001100001100001011010001000100000001110010001100001111000110000000010010000001001011000011001000
01100000000010100000000000001011000010101100000010000011001000001001000000010000000001000110011101001
10000000010100001000100000110110001110000001001001101011000101011001111000000000000011001000000000011
00101010001010000000001001111110000111011100001001010001110000001100010110100000000011000000011001000
01001000000111001001010111001001100000110000100000101010001000010100000000010001011101000000100010011
00001001000010001100100000100010101000000100101001100101000010000100101011000100000101011101001000001
00000100001100010000111000111100100100000000111000000101001100100000000010000010100001001110100010000
00000000011000001000010111000010010101001010100001011011110101000000010001001000000100000000000001011
00100000100011100100100010010000001100000100000101001001010010100010000001001100110101000000000011001
00000100101000000010001100000001000001001010100000000110001010110110011000001100110000100100001001001
00011000100000000000101000001000111111010010000011000000010000011100101100010000000011000001101000001
00000100001111000101010000101001000111101000001110110010001001001001110101011110000010001010010101000
01110000000110000001000011101001000000010110000000110000000000111000000001010001001000000010100100000
00000000000011001100001100000010000100100101000011001000101101000001001000001001010000000000000011010
01001011001001000000000100000110001010011011001111100100010011011001101010000010000011111000100010100
00010001000010010000001100010010000110000001100000110011000001000110111011100001000000100111010101000
00100010000100000001100100000000010010000000110000000011100100000001111010101100101000000001000010001
10000000001000001000010010100011000100110001101101001100000110000000110000000010000010000011000000000
11010000000110000100000001000010010000100100000111101011000000001000000100000011101001011000000001110
01100001000000101001001000001011010010000100100000101101001100101000000100000000000010000010010011000
00000000100000010100010000100000000000000000001000010001010011001100100110110101001110011001001000011
01000010000011101011001000001010010011100010001001010001001010100010010100100000011000110000000100010
10001100000110001100100000100010000011010000001001001100111000001100100000000000011100000010010000000
10000001000101010000001100000000011110000010000011000100010001010000101001010011100011100110001011001
00000011000101010101000000000100000010011101010100100001010110011000100011010000000000001001000000110
00000000110100011000100011110100010000010111001000011001010000100001000010010000100100100000001010000
01000000000010000000100000100001001000000100000100101101000101000111100001101101000001011100110000000
01000000100000000000000001100000000000100001010000000011010000101110010000011010001001100011111010001
11011100100100001000000011100000101010000011110000000001110000010000001101001110000001101011100100010
00000100100001000100010000101010101110001100010110100001000100000010111001000110000001000010000101100
00000111000010010000000001110100000001010000100011100000110000101100100000011001101000101110001100010
10101111000000001010111000010100000001100000111000101010111111000000100000010010110111010001000000010
01001010010000101000001010101000101011000000000000011010110001100011000000100101000010100101100000001
01000011000100010000101000001000001000100001010000000000000100000001100000011010001000000110001000010
01100010001100000000100000000101100000001111001010100001000100000000010011000000110001000100010100000
10001000001010000100000100100000100010010011001011110010000010010010000001011010001100100010100000010
00010001100001000010010100101111000001001101000010001101000010001011001001000000100010001000000001000
10000000001011010000000110000000100000000001111010100000011010001001010000100000001101000001100000010
00011011011100000000100000100101000000101110000000000010100000100000001000000100000011000001110000000
01000011001110000110010010100010100101000000001000100000111001100111000001011001000000000000010000000
01000001100010001000001011000010100010000010110100000100011001100000000101000100111101001010000110001
00100100000101000000011000010000000000001001000100100110001010000000000000000000000100000010000110001
00001100000001100000001001010001100001000001100111110100001001000110111000001011000011001010101010000
10000110010010010000010000010001000000000000000010100010000101010010011000010000001001000010000000011
01001010010000100000000001010000010000010100101000100001000100001010001011000100010001000010111111001
10101000010001000001100110001000000000101010000010001111001110000001000100100000010001010001000100000
10010010100101100100001111000000000001010100000000000000010101101100011110101001000000001000000011001
00100110010100011100100011100000000010001101110010010100000100000101110000100100001000010000010000000
00000000010000011100001000000000010010000000000111100101001110000001011000001010000001000000000000001
00010000011000001010000000001011001000011101000000010100001000000100010001000011000001011000111001001
00000001000010100011010000010100011100010001000100000000101001100000101000100001000100000010010010001
00000010110010101010010011011100010100010100011000000010011100000100000110000001001001100100000100000
10001101101000001000110001101000000001001010010000010000001101010000000010100000100000111100000010000
10000110101100010001001001100010000000100010000010001010001000000010000000010010000110000111000000010
00000000000011001001010000000011100010000100010000111100000000101110100100001010010000110100001001000
01010001010101001000111100100001000011101010000000100000100100011000101100000000000010000000001110011
00000000110000001010000000000000010000000000010011000001010110001001000001000001001001011100100100110
10010100100001011000100001001110000000011000010000000000001000010001010100101010000000100001000000000
00110000110100000101010001001100011100100000000000100100111000000001000000101001110100001110000110110
00101010011101111000001000100100010010110001001000011001001001100000000000100000000010110000000111001
01000000010000110010011000000100101110001010010001001001011000000011000000000011011000000110011001001
00011100011010000101100000110001000101010110001010101000000000000001000100000100100100000101011000010
01001011010010101011100001000000010000010011010000001100010101001000100111000101000110010111001101011
10000000101011101001011000001000001000011000100001011001000001000100101011010000000010000100010001110
10011000000100000100101000000001001001110000001000000100001000000000001100000010001000010000001100000
00011101010000010001011000000010011000001110011000011111101001000111100001100111100001100010000010000
10001001100101110000010101000010000010000100011001000000000000001001001010011001000000000000001000010
11000000010000001000001000000110001010001000000100111011010001000011010100010000100001001100011011001
01101010000101100001010010001011001110100000100000100110000010001110100100000100001000100001000010100
00100000010100001000001100000101000001100001001110111100000100001110010001010001000000010110100110000
00001110011000100000001010101010000000000110110111101001010011110001101100001100010010100111101000000
00010010100010010001001001000000000000001111101100110001010000101010110000000000000010001000011001001
01101000000000000100000010000000010000010001000110100001001001100110000010010100010000000110100010100
00101010000000101001010001011010000010000001100000010110001000010101000010010100010100100101100001000
10000001100000000000011001010000100001001001011000000110001000000110100100001000000100000001101100000
01001001010001100010001000000100010000000000001101000100010011101001000110011100100010000001101011000
