00110011010011101100001001000000001100000000110000001100000101000011100000000100011010010010100010011
00100100110000000010100101100001000010100000000000010001010010100010001000101000001010000001010111010
01000000000011000100000100000000000100000000000000110010000010000010001101000101010000001110000110000
00000100010011011101000011000010100000010100000100010000011100000110110010000000011100110000000011000
00011001000001000001011001011010000000001100101001000110000010000000001000110100001010101010001000100
00000010001000000000000010100010000000010001010100001010000101101001000010110000101000110100000010011
10000001001011000000100010000000010011101010010010100000011000100000100110000110101000010000100000000
01100000000100000011001001101000100010100110101000001001110101011101000010110000101011001000000000100
00011001100001110100001011010000000100010000110001000110000010000010100000000011000000001000110100000
00100000010010000001000001100010010000000110001001000010100000000000001000100100100101011101001000000
10100000000010100110011000010101000100001101010110001000010100100101000001001000001000001100010000000
00011000111000011010000110000000010000000011010001000001000101010000100000100000100001001000000000000
01001000011001100001011001000110101000000110010001110000100010000000000010000000101111100110000100010
00000010011101101110000001101100101000000001101000000000010000000101001010101101001001010010100001000
01100100001000011000110001001010010010010111001010000001100111101100010101100000000001111001000000000
10000001110000111000001000010001011011010100100010100000000000001000001000010010110000000010001000000
00010001001001000100100100010101110000000000000011000010100000010000001110001100000000000100110001001
00101100010000000000000011010000000101110010010010000000000000001011000000000001001010000010110001100
01001010101000000100011010000011000001000110000111001110110001001011000010000001011110001010000010010
00001001000010111000000111010011110000010100011000011001001110001111100001110100111110001110100010000
00101001000001000101101000100100000000001110000000000000110101010000000001111000000010011000010100100
10000000111101100000000001100000000000000110110101000011010001010000000000000000100000000011001100000
00000010010000010001000000000001010011000001001000001000000000000101111101001001000000010001101001100
11000001001010000000000000100010010110110100000001110000000000001100000001100010010000000010011101101
10010001000001001110000100001000000010110001111010011100001011000010100010101010000000000000100001000
10000010111110100000110000011100000010100000000000100100001001000011110010100000000100010010100000010
00010010011000100000100100010100011000010000000000100111010100011000000000000001000000010000111000000
00010001000100000101010010000110010001001010101000110001100001100100010011000001100010010000010110101
00010011000100001011001011101000000010101001000010000000000110001000000000101010001010011000000000000
01010001011000000001000110001000000010000010010010001000001001000000101110000000000001111100000010110
00100000000000010010110000010011011000001010000001000000101100001000000000000100110000101000000101000
10000100110011000101000000000000000100000010001010000100010111100000110000010000011001001110011010100
11000100110011000001000000100000100001011000010000100000001000001000001001000000100101011000000110000
00010000010010000110000000010101100001001001100100000010000001100000001110010100010110101000100000010
00000001000010000101100101010100100001000100100101000110000001000011110000000000010010101000001001000
00001000010001100100000111000000010101010000000000000010000010001000001000000001011010000011000000010
10000100110000000001010100000000010100101001000011000100000000010101000100000110000010000000000000110
00000000001000001001000001100000010101110011000000110110000000101100000100101000000010001001011000010
00101000000110010100110001000100001010101001000001010001001010011100001111010001010000010000000011100
00010100000001000110000000000000111000110000100000010000011100000100000010110000000010010010000000010
01000000000110000010000000110000000011000101111000010010011110000010100010010100000011000010110100000
00111001000101001010100011000101001000000011000000000000011100000011101000000000000001000010000011001
00000000000100100110101000101100000100101100001101101010011000000000100001100010010100001000000000100
00100000100010010100010000110010000100100000000110100001110001010000000110001001100000010000010111000
00000000000010110110011000100010101010010010101010011110100100000010000000000000110011001000111010010
10000000010100001101001110111000100011010111010000001000000000010100000000000100000011000000010100010
00100000000001000010000011010000000100100000001000000011010001100010000100010000101001110011100001101
01010100000001000100011010001100000010010111000010000000001010111100000001001110000011100011000110001
01100001000000001110000100000101011010000101100100101000000110001110010100000110100001101110100001100
00000000000001001110000000011100100011010000000001010001110100100000000101001000010000001001001100010
00011010101010001100001000110001000000100000000111010000000101100101010010000101100100101110001110001
00101101000001000000000010010000000001100000000000000000010111001001100001001000010000000000000010000
00100000001010000001010100000010001100010001100101101000010000010000101010101001000110100000011000010
00000110000100110100001001000000100000001011110010111010000110100100011001101011100100001000100010001
01100100010100001001000101010000000011101010000011101001010000110001000000101111110100001010111010100
00000000000001100001110000000000000000000011010001100000000100100001001101110011001010000001000011111
10000000101100000100001000001100000011011110110001000111000101000011010001100010001011100010101001011
10001000000111000010000010000000010100000000100001000100100010001010000000001000001010000000100011000
01010011010100001001001010000100010000000010110000101000101000100100001100001001010000000001100110000
11110001000010010000001100000011110010111100010000010010001101000100001001100000110111010100100000110
00000101000000001010010010000000000000111010111010000000011001001000010100010001100000000000000101000
10011010100110110010000101010100111001000000110000010010010101001000001010001111011111011001000110000
00000001001100010000100001000000000000000110000100110101101000000110000000101011010000000000011101111
01000010110001000001000000101000010001100000100110001001110000100010000000000000011000100010000100011
00100001010001000100011100111010000001010011001010010000000110000000000000111001001100011100000110100
01000100011000010101000110001000001010001000010001010010001000101000000010000110001000001001010100010
00000010000001011010010010100010000001001001110000000000000100000000110000001100000010001000000000100
01000000010100000001001000001000010100110110000001010001000001011100000000001011010101010100010010001
01010010111110010000001001010101001101010000010000100000001000000100000100101000010100001101100001001
10010000010000010010001000101000000000001100000000100001000011000001000000000000000000000000010000001
00010000000000110000100001010000110010000110100000100101100010001001000000010000001001001011000101000
00000011001001000001100000010011011011000010001101001000000000001001001010100101100110110110001000000
10000000001010001000100100101000010010000100011010000000100110100010000000001010000000010101100110010
00100000100001000000000010010101110001000001100000100000010001000001001011010010000101001000000110001
01000000000000110110101000100010001010000000000000111010010000010101000100010110001011000001011101011
01000000000011001001111001001101001001100001100100010001000001000011000001000010111000000001000110100
10010000100101101110110001011001000000100010000100000000000100000001000000100101000101000010011000100
00010011010000100110100010100011100010000001101000011001000001100010000001010100010000011001111000000
10000000010010000010000001001110011000101010011111100100110001011010001000000000111100001000010001100
01110000010010111000000110000110100001010101010001010101000100110001000001001010000010000000000011100
01100000110001110000000100000010000010000001011001001100000000100001100001001000000110000001100101001
00101000000111001000000010001111111000100000001100001010101100010010010110000001001011011001000011000
00001000000010000011000010000100000000011000010000000001000110000001010011001011100001001000010111010
11000000000000110100000100001000101100100000100010000100000001010000011000001010000000010000000010001
00010101100000100000000010111000100100010100001000001100100000111000000011010111001100010000010000000
10100111110100100010100001011100011100100001101000100011000010001101000011000100000000000000011100110
00111110010100011000000000001000011100101000000001100000100010001101000100001010001100000101110000010
11000001000100110010010001101000001100100001000101100011000000111101100101100010111111000100000100100
00110000000000000001101100000001000011100110010010000011010000000000000101000011000011001001111000100
10000010100010010010000000101001000000000010000001100110000110000000000000111000011000000000111000001
00000110100100010100101100110000010011001000000110000101000000010001001111101011001100111110010011010
10101000001110110100100100110110100000000000000010010000000001000000010000000010101100101000000001101
01100100000000100001000000010011110011000110101100100100000101000000000000101000000000011010100000011
10100000001000000011100001010000001000000101010000101111000001101001110010011010011100000101001001010
00010010011011101110000011100000001100010101000000100000000001000000100010100100001000000101010010000
00000000110111000001010101100010010001010000011000110100110000000010010100000000001110010010000000000
10001110001010010000000001011000000000000000011100000000101100010000000000000000110100000001110101001
00010100000001000111010011000001000010010011001000000000000101000000110010101000100100001000111000001
00000101011100000000010000100111000100000001000110110001001100101001110101001010000000001001000000101
11000001000001000101101000011011000001100100000010000010001100110011000101011000010011100100010100000
10110000001010100110000100000011100001110010010110011010011110000100010101100101010010010000100000101
