00100101000000000000111000010110010000000101000011000110100011000001000010000000110110010001001000000
00010001011111010010110010000101000010000100000010000011000100010000001100010110010000010101100111001
01011001101000011010100100101000100100000010001011010000001101000010001100000001000110010111100111000
00010000100000000110000001110010001010100001001011001100010010011001000000111000000000101010000000110
10000100100110100000100100000000011010110010100000010110001010010100000001001111010010000000010000000
00100001100010000000000001001000100111000000011000010001101000000000010000100000000000001010110010011
11010110010001000010001100000001110000110000000100000000000010010000001101001001001100000100101000000
01010100000010001100100100110100010000110000011011001000010001101000001010000000110011111000001010100
11010000000000010011000110011010011000000111010110100010100010011100000000110100001001000000000010000
10000001000011100000001000101010000010101010000101011000000010100101001010000100000000001000101100000
00010000000000000000110011010001101110001000000110001000100000001001000001101101001101010000110011110
00000110000101000101000001000010010111010010000000010001001001111110010010001100000000000100100000100
11010000001100101110001110000000001000000000010001010000001000100011010011000000110001001000111010000
10000010001100001011001000001011011010100011000100001001111000000110010000111000010010000000100000100
10000000000000100100110001101100100010000010001001000000001110010101101101000000101011000011000000100
10000000100100001100011000001001000000000001101010000000001000001000001011010101100001100110000001101
01000000001001000000000001010100010010001001010110110010111010011100101101010110011001000000000110001
01000010100100100100000010001001100010101100000100000010010001000010000001001000110100000000010000010
01000000001100000000001010000011110000001001000001001000010011000000100001100110000001000000010100100
01110000000101010001101010001001011100100000010001001000000000000000101000000110001110000100000010100
10000111101000000111000000000001010100000100101100001100110001000001001010000000001000100000001001101
01011001100101001000000000000101000000000010000100011000000001000100110001001010000000001110011000011
01000001100100000110000000000100111010100110111010010010110100111111000000000101000000011000000010011
10010100100000001101110000010000001011000010010000000011111100010000000001101000001000001000010100001
00000001000010100010011000001101010101000100001100110011011100000010010100100000000111011110000000001
00101000000100000000100010011000000110110000101010000100000011001000110110100001000001011111000010001
01110100000100110001001110000101000010001101000000010101000001101010000000100000110001000110100010101
00000100010000100100010010001000100100010000100000101100001001000010000010000000000100001000001110000
00000000000100000000100111001000000001000100000100000001000010001001010010101110000100000110011000011
10100001000010100000010001000101001111001001000001011101000100110011101000001001100000000010110010010
10100010001110010001100000000101010100001000110000110001000010100000000100001011011110110000010000101
00001011010010101000110001010000000011111000001001010001000000000000101000000011100010000101000000011
10010101010000001101011100100000000000110000101000000010001011001100000001010100000101000000001100000
10100000010001100110000100000000010001000000000000100001001000010001110110100001000001100000001010100
00010010001100000011001000100000000010011000000110100110000111000100110100100100100010101101010010010
10001100001010010110100010010000011010001000101010100001000100000001000001010011111100010100000011000
00101010000000100001001000000110111000010000010000100001000100100011010000000100011010000100000001100
00011010001000001111101000001100000110001001111100001100000000000100001100000110000000000100011011001
01001000100000000100000000100000000000001101000100000001001001001100101100001001001000000011011101001
00001100110010100000000000001110100010110110010011000011110010100010001111000001010110110000011000100
10011001010010000000101100101001100011000010110110010110111100000011100100000000001100001111001110111
00000110100010001000001000001000101010000101011100001000010000000101110010000010101010001101000100010
00010000000000100000000000010110000000001011001000110100110010000110000100001000010101110100100111000
10000000100110001000010001001101000111000110110000001000100011110101000000000001010110001000101011000
01000101001100000000001100000000001000100010011111110001001000010011000001010001100100000110000000000
00000001010010010110000000000000100010110000000000100010001010110000101001000010001100110010000000000
01100011100111110000000000000101000001000001000000000100010110000000000001001101010010001001000010010
01001100111001000000000000110000000001001001000000100000011000000000001010000010010110001000100101001
01100101010110101000110011001001011000100001000000000110010010000000101011000000000000000001001010000
00000100101111000111001010110001100001000001000100100110111100000100100001000111000111000101000101110
01000101100101100010000000000000001000000110010101000000001100100000001001001000010001101101110001011
01000001100001010011010011000011001001010110101100001010000100000001010110110001010000000000011010010
11100100000101000100100000001010001000000111000000010001001000001110000010001001010001000011101010010
10000101010010000000100110000000001010000010110000011000001011001100000110000000000100100010010100001
01000010100100001011001011011110001001000011000010001000011000010011000000000100100100111011010000001
01110000001100100010100001000000000000001110000000010001001100010100001100001011000001101110000110000
00001000000011000001111000010100010100001101001100000100000000100110001000100001000000000101110100100
00000011110110000100100010101000001111010000101100000001000101101010001010100010110000000000000000010
01100001000000001010101000001110101000100100010010000000100000010110000001000001000110010010010001010
11100100000000000000001010100001110000111001000000001000011001001100000001101100001000010100010000100
00000010001110100110010101101111000110010000010000101000000110000000100001001001011010000010000110111
00000100110011011100110100000000000111101001001000000001111111100000010001000000000000010110101101100
01000100000101100000101110100100101000000010010100000010110010010101011110000010010101100001110001001
00000001000000001000110111000000001010001011010000000000000000001000100000000000000101100100100111000
10000000101110101110100000000001001101100100001000000000010111000101000001000100000100100000000011000
10001100010001010000000100011001000101001000010010011111001000000010110001100110001000100000001000010
10010100000110101111010111000110100000010000000011101000000100000111011101000100000100001000001100000
00000000100100001010000000100010100001101010010001000011001001001000101000000000011000000010000000000
00001000010100000010010010000010011000101000010000101100000000000010000101101000001000000000100101001
10000000100100000000011001000000010110000000010011110001010010001001000010000110000010000000100001011
00100110010101000011100000000100000000100010000000010000000011000011000110000000000110100000001101011
10101010000000000110000100101100000001100000001011001100000010100010000000000101001100010001000000011
00000000101010000000010000111100000001000100000000111000000110110000001010000010001000010000000010000
00001000001010000001000001000010001110000001000000000101010110011000000110101000010000000000000000011
01110000100011111011101000010100001001000010000100010001100010001100000000010001000000001100100000101
11100000101001000000100000000110000100010111001010000001100010000100010011000001000010000001000010001
10001001010000000000100000001111000000001010101101000100100101000110001001010010000000011010000101010
00000101001000100011010001111000100011010100001011101000111000000001001110111000100010000000000001010
01000000010011000001010011000100010100100001001101000001010010010010000000111010010101001001010011000
00010000000011000110000100000011111001000101001010000000111010001100000101111011100000001001000000010
00100000101000000110010100011100000000001010101001000100000000000110111100001000011000000010000100011
00000000100011000001000000010001110000001000110110000000000001111001000000100000010000101001000000101
00001000100000101000100011000100011101000001000111111100110010000000011000010100101010000000011001011
00010100000010011110111000001000011111001000000110000000110000010110011011101000010000001100000010000
10100110000000000110000000101000010111000100110101010000100000000001010010001101000011000011110100010
01000010010000010010000101010100010100000000010001100100000000100000001000000110010100110000001010001
00110110010000000000101000100100100010100110000000110000001000111100000000000001110011100001000001101
01000000010000111000100000101100100100110000010001000100100010101011001000010001100010000000000100110
01000000000000000101000101011010001010100101000000100100100000101001000001010000010010100000101010100
01000010001010100110001110000100001010000010100000000011100000011100000010010101000000001001000110001
00101100000100000001011111000111100010110010001110100000000101100100011000000001001100000000010110111
10000010011001001001111011110010000000000000010010001011001110101011000011001000000000010010000001001
11000000000011100110000010000001000000100100000101101010101011001100001011000001000000000000000000110
01100000000110011100000001001100110000100010000000000000010100000110111000101100000100011111001100100
00010011010110000010100010101000000101011100011110000000110100001000110000101010011010011000100000110
00110010101011001010000000110000010000000000010100100110001000000000001011000100000111010000000011001
11001000101100101001000110001000100110001011110101100000000101100000000101101010001010011000001100000
00000010000010111000000000001100000101100110010000000100001010001000000000100000000000011110010000110
00000010110001010010001000110001000110010100000100100111010110001000000010010000000010010101001010100
00001001000011010110010000110100000001100011101001101100111111110000001010001010001000111101011001100
00000000100000000001001011011000100101000100001000111101111000000010100011111001101001000101001100010
