10000000101001111000000010001000001000011100000001000001011000001000011010001000001000010000000011011
00000100100111000010101101001011000000010000001000000000010001101000001000000110001001000100110001001
00010001111110001100010010000100000001110010000100011100000100010000000100000100111001100110101000101
10000001000100110101110101000000000100000001010010101011100000001000010000100000000000010000010000000
11010010000000001000001010000001011110100000011011001001100110000000000000010001100000011100000001000
00000000000101101100000100000100000001010000101100001010101100010000001010000000100010010000100000100
10010000001100001001101100000000000000111010000000110110100001010100100101100110010100001110110100010
11100000001011001010100000001100000101011110010000100100010100110100110100001110000000001010100100010
00010001001101110001110000100000100010000011011000010000010000000000000010010000110000000000000101000
00000100001010100011010010101001000010100000100110001000000100010000100101011000110000011010000011000
10001110100000000100000000001001001101010000000000010110011010010010001010001111000000001010110010010
10000010000101101000001100111010001100110110011001110101110101010100110000110010001000000011000110101
00010100001001001010000000000101000001011000000010000111000100010000000000100000000011111101111000000
00001011100100001001101101000001000001010100001010010001100000100010100010001100000001000000000001000
00000110000000000110000011000010110001001010001000000001000000000001001000100100000101000010100100010
10011101011110100010000101001001100000001010100101001000011101101101001011001111000101000000010010100
10000010101001000011000010100110101001100100001010100001100001101000011001011011001011010000010000000
00011000000000100000000011000110000100001011110010000000100000101100000100000100010010001010100000100
10011101001101000010011000111010000010000000101001011010100100000001000010100010001010010100100010000
00100001111010001000110100010000111100010011001100100000000100101101000011101100000000000000000100001
10110001000010101001000001011000000000100111001101000000000110010110001110100000100011110101001010000
10010100111010010001001100010000000001000001100001010000000010000000000000001001001100000010000100000
00000000000001100001001000010100100001001000000000101000010010000101000000011100000110000000001010010
00000100000100100111010000000000110001000110100101000000101000001010000010000000010100000100110000010
10001100000000100001100100000000010000001001100010100011000000010011100100101000010110001101000001000
10000111010011001001010010100100010001100100000101001010010111000000100010001100100000010100001010011
10001001100001110001000000010100000100011100111010001100000001110001111010100000000000000000110000010
01111101100010101000001100001100000010000100100011001000000100010010100100100000101000100000100001000
00000011010001001000000100000000101000010000000010000001011011000000100000011101100110100000010000101
01100011000011001001100111011001000010101000000010100000000110000100000000100000010000100001101010010
01100011001011010000001000101000000011100010010000110000000000000100011110000001000000000010000010100
10011001100110100000100000100110000100010000001110000000101101011101010000000000000000010001000000000
00100000010010100000100001000111010011010001010000001001000000000110010001010010000010001010000000000
01110000100011000000100000100001010110000000101000010000011011100001000100010001000000100000000000001
00101100100000010001000000001000000000010000100000101001100000100010010000000000010100001110000101100
00100111000110100000010100000000001001000101011000011001001010101000000011010000000001101001010001001
01101001000000001000011001110000101000000001101100001100011110000001000011000111000001000100000001100
00100011011011110111111100000000100100011000111100000000010100001101001011011101001001010101110100001
00010010010100000000000110000100010001000000100001000000010000010000110011010001100000000101000100000
01011001000001000000001000110000000010110000101001100000000100101100000100000000011100001010010001000
01000001000101001101000100100000001000011001010111001010100100000001100001000010010110100000000010000
01100110000001000101001110100001001001110100100100011000010010111100100111010000110000011011000101111
10000110000000000011010010001000010010101001001101000010101110010101001010000000001010000100111000001
01001000000110101101001001010010100000000100011110110110001010000000000001110000110001100000000101010
00001011000101000100001000101100100101000000110100000011111010000011100010000101110010010010000101010
00000001100000000011001101010011010110000101010000000000101110000010000101100100000110000101000011101
10000100101000000100000001100011010000000111010111100001010000001000000000001100001101000011000010010
00100000001001000010010000000001110000010000001000000011001000001000110010000100001000010000000100100
00001010010000001100101010000001000000000111000100010110000000001000000000100010001011001100010000000
01111100100000001000110110100010000000000010010101100110000000111011110111001000100010010110000000001
00010010001110111000101100000100110010101000010000000110010111000101000000001010001011000000001100000
00001111100100000001100110101000001001000100001101010100000000010001000000110000000100100011011100110
00010010000000010010011110100010000010100000010001000010000000100000100100000100100101011001000000011
00111000000011110000101000000010000000010001000011101100000011100010000000010100010001001011001011000
10000000101000001010100101000110100000000001001001000010001000010100000011011011000000000010101000010
01001000000010010100001100000101100001000100001000000001110001001000000000101000011000000101000100010
01000111000010010001001000001100100001000000001101011110000110000000000000011000000000100010101100010
00111011100001011011001000101010100000010000100010000010000011101111100000100010001001100010010000011
11001000110001010111100001001010101010001000000100000110010000001000000100001001010000010010100000100
01000110010000001011011011101001101001010001100000000000000000110000000000000111000010011101001010101
00000101100001001110010000100101010011001000000010100001100010000000110100000000001000000000100000101
10010000000001010001000000000000011101000000000100100000110100010000000010000000001000000001001000100
10001000100000000001100100100001110010000000011001010000010000001111001000000000001100100000000010010
00010110000000001111000000000000110010010100011000001110010110001110100111010010000100001010000010000
01001000001001000000010111000100000001101100100001000011100001010010001100000011110010100101100100100
01000001000001010100010010100010100100101000001001101001010000010000000101000101101010010100010101011
01000001100100010001101100101010000000010000011010000100100100101001000001000011101000010001001000001
00100001100011011000100001011000101000000100000001000000101101000001100011001000000010111010001100000
00000000000100100011001000000010000000000011010000010000000100001010010010000000000010000100110110010
10000000110010001101100000001000001010011010010000100000001100011100110000000000000001000001011001000
00100001000101101000101101010000010010000000010110001010010110011010000011101001111001010000010000000
00001101100010010101000001011111101000000000000100010010000100001010000010110100001001000011010010110
01000111001000000001100100011110001010100011000011000000000001010100001100111100100001000100110001001
11000000000001000110100000010110000000000000000000000001000001010001000100100100000001001100111100000
11101001100010000111110001000000110000111000010011010001001000000000011100000000000001000000000110100
01000000001000001101100110010100001100001011001010010100001100101000100011100000010100011000001000011
01010001000000100100000000000001010000010011110000001100010110100010011001001100100101100000001100000
01000000001110010110100100101001100000100100110100101000000010000010000011000000010010010000010000001
10011110100000011000101000010010110110001100001010001001000000111100000100100110101011000000000100000
00001111000000110000000001000110100000000011000101001001010001011111000001000100101000100010101100010
00011010100001000100010110010101110000000001011000001000101010100111001011101010110000001010100110111
10100000000000011100000000111000000000000010100100000000101010001101100000000000001000010010001001000
00000010000000000101110001010101000000010001010100000100001000010110010000001011010000000100001000000
00010011000000111001011001010101000110100110101000101100010001010100000000110000001110000000000000001
00100110101001110010001100000100000000010110110100001100000100100000000000111000100000000100000000001
10000101101010000101111000100100001000100000001000000100100100011000101000000011111010100100011001101
00000100100100010000101000000100001101001000010001000010000010000010000010100001001010110000100001000
01000001001000010000101101001010010010000000100000000001001110100010000000000001101000001110110101010
00110000110001100011010101000001101000010101100000010001100000101010101001010001000010011001111010011
00000000000010100100000010001000101000000000001000001000001011000000110010000001101010010000010100000
00000001000010000001100100101000001000000000010001010111000000000100010100001000010000001001100010100
11000001111000100100001100110101010000000000000110010110000000000000100000000001001000010000000000001
00010000011001010000010100100000110111000101001000001111100110100000000001110100100000000000111100110
00000010111101000011000110011100100000000001101001101000100001101100001011110100010100000001000000000
11100000000101000100010110000000011001001001010110101101011000110011000001100001000100100010001001000
01010010001001000000110010010010101000001101000010010000001111000110000000000100010000000000001010000
00110001000001000101000010100001010100101000001000100010010000100010110000110001011010101000010001000
00110000010011000100010000001010110101100000101111001001000010100000001100110000011010111100000111000
00001100011111011101110100101001000001000000001000101000000000001000100000001000011100010010000000011
10000101000010110100010010000100100001001010000000100001100000000000010000111011110001000100001110100
00010000110000000101100000000000100000001100100010011000011100010000000000010000000100000000001000000
