00100111000001100000001010000000000110001000010001000000001100000000000110000010110010001000001000100
01110100010000101100000000001010110110011000011110111101011000000001100001010000010000011100000000101
00110000000010110100001000010000000010011000000000100100001100000011101010000100000101000000001000001
00001001100001011000010111001001000000001001011001000110100011010001000011000000010100000011001011100
00000000100001010010010011001010000100110000000000001000000100001010101001100000001001000000110001000
00000000101000010011010000010000100110101011000100101100100000000100110000000100000111000000101000000
01100000110010000011000000001110110010000001010100101110010000010110000010011000000001000010011001100
00000001110011100100001011010101011000010101000100010100111001100000000001101010100011000000010111100
10011001010000100000011000010101100110000001000011010000001000000100001100000010110101000000111001010
10100100110010100110101010000000001100000110001000001010010010001010011010001001100001001000100100000
00000010000100001100001001001001001100011110011001110000100011000110100000011010110100001010000111000
01000010000010000000001111010000010010011101100000010000100000100001000000010010100000010011001001001
10100001101000111000010110000101000110010100100000010001000000000010100010100000100000100000110001010
00011101001010010100011010001101000000010001011010101010000010010100101010101101010111100000000100100
01000010001000000000010100000101010011100000001100100100000001010000100011100010001100100010000000110
00111011001100100010100001000001100111000000000110001000100100000010100000000101101110100000000000010
00000110000101100100010001101011011110000101001010000010100000000010010110001100100000000000100000000
00011001000001010000000110000010100110001000011000001000101100110101001000100001000000000000000011001
01011101000001100000000100100011010000100111000001000011000101111010111000010010010001000000000001000
01000000011010100000000000001000000000000011100101110001011001110001001001001001001111010100011000011
00111000100000000000100010000000010000000000110100000010100010000000000010111111010001100100000010000
00000001101011010001110100011000001001000110000001101010100000000000000000101100010001010110001000001
01000010110000000010010111100100000100110010000001001000100000000011001110011000100101100000000010100
00000000010111000010101101010001000100000100100001000010010000001000010000000001111100001001000000000
00000010001000000100000110100010010001100011010101000000100001000000000001110101000010010000101100000
01000000001000000000101000100110000100000110000000101100000000001100010000100000011010010011100100011
00000101010000001000100100110100000000010001001000100011100100000000000000000000001000000100001101000
10010101000000101001001001000110000000001000000010010010001000111001000010100001000110000000000000101
00011100000100000010001110010010011001000101010001000001000001000100001011001010111000000001000000010
00000101000010110000110000001001000001000001100100000001001100000010001001110101000000010001010110100
10000000110101000000010000001000101111000000000000010000100100010000100000101100100001101011001000000
10000101011000110101101000000000101001000010100000100010000000000001001000111000000000100011100000000
01100001001000001000010000101100000001010000100110000101001100000100000100100111010000000010010010110
00101110001010110010010001010101001001100000110100100011100100000001101010000110000111000001000110000
00100100010000101000000111011001001000000000111110100000101001100010001001110110000001100100100000000
10000010011001010100100000000101010000000001110010000100001001001010111100101101000000100010000000000
10111000010011010010100001000000010100101000100000010001000000110010000010100011010101011010000011001
10001000000101011001000000000010000011100001000100011110001010100000000101100101010000000000110010000
10010100010101010001011000110001001100010111101100011011100010000100100000001001001000110100100000011
00010000101000100100000100000000000100011101000001101001000000100010001101000000101000001010000101010
10110110000000100110011001110000001001001100010010100100000010101100101111000111000010010000010100100
01010000000011100101111000100000111000100001001000000010000100000110000101110001100000110000000100000
01000000101000010110000101000001000011010101100010110000000010000010000000000001011101110010000000000
00101001000000100100010000001001000010000000100010100000011101101001101001100000100000100001010000011
00010010000100000111011001011100000000011100100010000110000000110001000100001001100001010000000100101
00000010111000100100001110011010010110000110100000010000010000010000000000000000000100010000110010010
11010010100001011010001000001000000001011000001110010101000001101001010000000111010000000100111000001
00101000100110011000011010000001011100000011100101000000100100010010000001000010000101010000100000000
01101100101000000001100010010011000001001001100110101110000100100101011001000000000010100001000100001
00100010001011001000010010000001100001100100001101011010100000111000000100000100101001010001011001001
00010100001010001111001000100100100000000001010001101000110000001101001010100010010100000000100000000
10000001000000010011000111001111011000000001110010000010100101100111001010000001000000011000000000001
01000111111001100001000000001110100001000001101001001000001000000001111100010111101100100100010010000
00110010000100000100000100000010000100010000100000001100100000000000001000000000001100000101010001000
00101000101111001000010100000010010010000011011100000001001100000000001010010010100110110000000111100
10000010001110000000000010110001100001001000000100001001001000101000000000011100101001000010000001000
00000100110000001010000100010001011000001110000000011010000000000111000010100010101100100000001001000
00001010101011001001000001010000000001000001100010000011100101100100111100000011000000010010000000010
01010100011100000101110110001100001000110000010000011001000000000101101000100100000011001000000111100
01000101000000000001001001011000001000000000110001100010000100000110010111000000001000000000010010000
01010101111000010010000001000101000100000100010011000000110001010110000101000000000011010110100110101
00001110010000000011000011010100000001000001010001000011100000100010001001000000110001000000010100000
00010000001010011000100000000010000101010000001101000100101010010001010000001100010100000010010001100
01010000011010100011000000000101000001000011010010011000100001000100010010010000100000001100001001000
10000000000100001001100001000010110000100000000000001010010110110000010000001001010100001010000000101
10000111000011100010100000001001100011000000010001100000111000000010000000001000000110011100101000000
00010100100100010010000010100000000000000110000011000000010000010110100000001000001010001000000000000
00000010010000100010000010000000000101011000001000100000000101000010000000010011000110001000010001000
01000001100010001011011000000110001001000000110110100000010000011000000100100000010101000011001010000
11100000110010000010000000100000001000110000101000101000100010001110100101000100001000000001000010000
00010111011000010001000110100110101000000100001100010001000010010110011001000010000000101010000101000
00011000001110110010100100000000010100100000100000001100000001110010100000000000100000010011001110011
10001000000000101100000001001110000010001100000000000000000111010011000011000000110000010000001100010
10010110000000000000010111010011010000100000000000011100100000000010000000100001101001001010000101100
00110100001000000011010100010100001100001000110100010100100110001011100000000000000000001000100000010
00011000100010100000000111000000000000001000101101100100010000100000010110001000001100100110110001000
01001101101100000100010001001001000110000011000000000000100000100000000101000100001000100100110110000
00000110100100111100110000111000011100100000010010001001000001000011010000110011000101000100001000011
11000001011000000000010000010101110000000111001100100001100001010110101000001000001001010000100100100
11010000000011100011011011000001100101001011001001001000000010110001000001100110100000101000100000011
00000000000000110000100100000000000000000000000010000000100011000001000010010011001001100000101010001
00000110000000100001000100110100110110100110000010010100000001010110001101000000000000100011010001001
10001000101000110001011000101001000110001000111100110100110000010100000000010001000000001010110001001
00010000011110011010001101001001101000110000011000010100000000000101010000100000100000100001010000001
00000000000011001010000010010000111000010101001000000010110001100110100000001000000010000100101010001
10101111001011100100100000001101000000001011000000101001001001101100001000001000010110000010011000000
01000001000001011100010100000100000000100011000011111000001110000100001100100001000101100010000000010
01000010011001001011001010000100100000001000001000010100100000001101011010001000001000101010001010000
00001000010010001110100110111000000000001010001010100100010100000000100000000000000001001111000101000
01101100011001000000110000000000100010000101000001100001000000000100001000000000010110000100011100000
00100000001000110001100110000010100000110101000101011100010000000001000100111001010000111101000000100
11100000100001000001001100111010001100100001110000000110010100001000010000101000011010001011000101010
01000000001000000000100100000111110000001110011001110010000100001110000000100001000000100100011001010
00000000000001001000000000000110000010101110010001000000011001100010000000100010001000000001000000011
00001110000000000111110010010000011001010101010100000010101000000010110100101101011000000000000100010
10000011000110000101101000111011001000010000010010000110000000001011000000100011101000000100011010000
10001000000010000100010100100101001111110000100001001010101100101001010001100000010000100010000111001
10001100111000100000010110001000101100010100001100100000000000111000010010000100001100100100001100101
00000000000000000010000000101100000001000110000011000110010001000000000111010100011000000000100000101
00000111010010110001100000010000000011000001000010010010100000000000000100000000100101001101110010100
10110000000100010100001010000000000000100110010010010100010100000011100110101011001011001010000000011
