11011110001000001000000000100001100000100000110000001000000000001001011101010011000011000100100001001
01001000001000001101000001000000000010000110000010000001010000100001000000000100000010000100001100000
10011100000000010101001000010100100100010001000011001010000010000001101000100001101101000000110011000
00110000101010000001000001000100011000110010000100000000101011011100010000000010010000001000001001000
11001001001010001010011101001001000100100100000010100000111000010010001001100010000011100110010001001
00000010001000000001101110000000000001000100000000001001000110001011100010100000000100100001010110000
10000010001111100000001000001111010000000011000101100001000101000001000010011000000010110100001001010
00000100001100000000000100100000011000001001010100001110011100010111000000110011010000000000111000010
10100000110010000001000100010001010000000011000000110000100000010010000001100111100101100001011100001
01100100000110101000001000011100000111001011000000000111100010100011100101000000000000100001001000101
01011011000000010000100000000100011101101101010100000111001000010110000001011010000110000100100011000
00100000100100000010001010000010000100000000000000000100000100100100000110000010000000111111100000110
11100000011001010100010010100100000100000010100111000000101000110000010011100000100000000000101001000
00001000000000000000001010110010010101000000001111100000011100100100000011101000000001000000000011000
00000001110000010010000010010001110001100000000000000101010101011010000000111010100100011001100110010
10000101001110000010000000110000000100000011010000001101101100101111100110001100000000000001000101101
00001000111100101001000000101010100110010000100010010001100001001000000010000100001000110110110000010
11000000000100111000100010000010000000000101100010001000010000000000010000011000011101000010001100111
00001101001010000000010000001100100100101010100000111010100110011100000010100010000011000000000000001
00100110101101010110000111100000000000000000001001000001101111010110011100010000010001101000011001010
00110100000000000100001101010011110001110100001011000010100000001000011101010001010011000001010000000
01010110000001101000001010000000010000110100000010010101100011000000001011101101000100001010100000100
10010000110001011001010001001011010010000101001001011001010010101100010010000000010101000000000001001
00011010110100110010010000000010100000010000000000100000100000100010000010000010010011000000000100110
10000101010010001000000111011110001100000000111100001100100000000000001011100000001010000010100000011
00000000000001000000100001110000110010000100011000100101011000010011000010001111000110001100000000000
01011010001001000000100000000100001001111011100010110000011001110110110001001101001001101111011010011
10000000100000000001100000010001101110001011000110010000000010000101010100000110001101001101000100111
10101010011001001100001100110001000000000000001010000000010010100000011010000010000011000101101100001
00001000100110111000010100100000010011001010110000000010000001011011101000001000010101100000001000001
10000110001000010000100001001010001100110001100000000100000101001000000011000001100101101110001000001
10010000000100010000100000000010011000001001101001001000010010101000010000100001010000000101000000110
11011001111001000100010000011101000110000000000010000110011100000010110010100000100010001110001101000
00010000000000000100100100111000010100110001001000000000100000000000001000001010000000100001000010100
00010011000100010010000000010010010000000101000001001100000001101001000000000011000001101110000100001
01010010110000001101000000001100110110000101100010000000000110110011110100001000010000000100000000100
01100010000000100010000110000110000111000000000111000000101010001111000100001111100000001101010001101
00000000001001011000001100010001000100010011001100011001111000000001010000000001000100100001010100100
00100000100100010100001001000010001000010000010101001010000111010000000000100101000000000000000101100
10000011110000010000000000000110000010101110010001000010000001010011001000001000110110001010000010001
01000001100000110000000000011000100111000100100110101000000110000100000001100001111101001000010001110
01110001100110010000110010000110100110000000011001001000000010100101010000000000001010001100000101001
00100010000101010001001000111110100101100010011001111000110000001000010010010010000001000001001001000
00110000000100101000000100001000000000000000011010110000000100011110000000000110000011000110001001010
00011000100111010011010000011010001010000000101010010001001011000100010110000000000110001010000000010
00011010111101100000010001001010000000000011100000101001000000001010011010001000001000010001000011010
00100000000110000010110000100010000000000101000001100010001100001100000101000001111100101000001101101
01010000001001010001101011000001101010000000100010001010010000010110010010000101100000110000000101110
00111001100101001110000000110010110010001000011101000000110000000000001111000010001010000100111000010
10001010101000000110010010100000001010010000101010000000100100000000011010000100010011110111001111010
00000000100111000000000000100010101110000001000000000100011110000001001001000000000000010010001101100
00000010010011000011000000001100000110100100000000000110000010100011010000100101000000010010001101000
00010000000100001010100100101000100010101100000000110000110000001000111000010000001000000001110011000
11100000001011010110111000000101010110001111100000000000011001000000100010101101011000100101000000100
10000000111011110000100010100001101000010010000010100100000100010001000010100111110000011001000000100
00010010000101011101010111000000111001000100001000110100100110010100001101000000000000010000000100000
11000100001001010010000010000110010001010000110100001011011000010000110010100000101100000110000110000
00000000000010011100101100010010001000001000000000100010001100011001010000100000000101000001000000000
11000000100100011000001101000100000100110010000000000100010001110000011100010000000010110010001001000
00000000010100100001000000000000000000101000000000000000000000010001001010010100001000010110000010000
11101000111010110110111000001000110000101001010000001100001111100010000001110010001110000000011101010
01000001000000001000000000010011000000000000100000000001000100000001001001100001000001101000000110001
00010010000000100000100110010010011100000100001100111100101100110000101101010110011010010000010100101
00100001000100011000000100101010000000001000110000000111000011000010000010000111000001100101000101101
00011000000001100100011101110001101110010010100010000000100000100010110010000010100001000100011000101
10110100101001110000000010001111001110110101001110000001001010001001000100000101110000100100100001000
00100011000000000010010101001001100000110011000000010101001100011010100010001101000011000011100001001
00001000000001100010110110010110101010000010111000101000000000010001110100101010010000001001000100011
00010000100100010000000000000110101000101011001110010000010000000000100010000100100100000110000011000
01000011000010010010000000000010010000111001011111010000010111000101101100010100011001000101000000100
10100000000000010100100010100101100100111100000000000010010110010010000000000010000100000000110110011
00010101100101101001000000100011000100000010001010010000100001100100101000000000011100100110000000001
10100000001100000000000011001100000000000000110000100001011000000000000010100001001100010000000000000
01100000010100000101100010001010110101100001101000000000000111111001100010010100100011101000010011000
10000001101001001001000000000101011010001010100100000101110000000010110000000100100100000100000101000
00001010001110000000011000100100010000001001000010011001000001000110000100000000000001000010000000010
10001000110001000000010001110001100010000100010000000000001001011110101000000001010001110101110011000
01000010000010010000010010100001100010011110000010100110001010000100101100010000101101000101010100011
00100000100000110001100100101000001000010100000111110001010000000100011001110010010100000010000001010
00101001010100100000000000000001001010001101011100011010010000010100010000000100100100001001010010000
00010110000101011010000000000101011000110100100000001001100000010000000101001000001001100000010000000
01101000100000110000100001010101000101011000001010011000100011010110000100100100000110101101011001100
00000001001001000001101000010010001001000010000000010001100010110000100011001000110000000001100000000
00001010101001110100110001000111000110000010000100101100000110000110001111001100000010000010010010010
00010100100000000001000010001010001110000101100011000000011010000000000101101000010001111000011001000
00001100000101001111000001000010001010001001000110000110111001010100001001001011000011101000011000000
00010000000000011010100101000001000000100001001000011000100000010010100001110101000010000110100000000
00100010000000010001011011001010010001001101100100000000000100000111010100000000000001001000000100100
00110001100010000000101000000000000100000010000110110010000000101000001000010010100101010000000000000
10000000001100100111110100010001101010011010010000100111000011001100010111110100100101000000000100001
00000001001000000000000000010001100000011101000010000000010100000010001011011000000000010000000001000
00000000100100110001111010111010110000000101101010000000001111001010000100000010100000000001100111011
00110000011000000010110001010001110111101000101101100011000000000010100110001000001000010010001000000
00001101010010000000111001000100100001010010100010100100000001100010000100001100000011000001000000001
00010010100011000011001011000001000001101000110000000000100010001011001010001001110101010000011000100
01000000000111000100100000010000001000000110000100000010010000011111010010010110000000000000001101010
00010010111100000001010000011100110100000101010100000001100111000010110001101100001000100000010010000
00000101000000100011111000111000100000000000011101001000010001001000010100101001110110000000110000001
00111000100110001100001001101101011010010100011101000000000001000000111101000000111000001000101101100
00000001100100000100110001100010000100100001000010010000011111001000000100101001010000000001000100110
00000000001011000101000000001000100000001000001101111110000100001110110110001000110101100000110001101
