11000000111111111100110000000000010010000001000001101011010001110000010001000101001001000010000100010
00001000000000001010010000010010000100000011011001010100001000010011110000000000100000000010000000001
00100100101001100100000000111000001001110111101010111000101001010010110010001010111000100010000000000
00100000010100000000001000011001011000001000010001000100110100100100001000000000001000000101001000010
00010001010110001000010001000001000010110010101000000010110011000100001000000101101001010111100010111
01001000010100001110001000100000100001000010100010100010000010001001000001010100000001000010001110000
00111100000000010100011000000000010100000010001011000100011000100110001001101000101100000011000101001
10001000010000101001011000001001011010000110000100000100000000100000000000001110001010100110000101100
00011000011101101001101110010100100000000001000010100100110001100011100000100010110000100100110001001
01001100001011001000000011100000010000100000000000000001001100011000000001001010011000000101000001001
01001010100010000100001001011110000000000011000001010100100001000001010000100000100000000000001010100
00100010000000011100110001000100001010101100001000110000100110000000100011010010001010100001111010110
00010000000110001010011000011100010001111000110010000111001000111100000010011001101010100001110000010
10110100000000001110000000010010110110101010100111010110100001100101101011100010001001100000010010100
10000000001010000000001010100110010000001000000111011000100000100100000001010100010010100011100001101
00011100010010001000000001000000110100000010000110001101100100100000100000000000010100101011001100100
10010011100001010000011010001000101010000001000100000000000000001101100101001000000001010000101100010
01000101000001011111001000011110011101000000010001000100110000000001100001100010000000000100000100000
00011011100100000100001010110011100100001100010010110001010010000111011101011101000100000010010000001
10011001000000011001100000100000100010000000011000000110010010000001000000000110101000101000100100100
10000110000000001000110100101000011110010110101000101000000100000101001000010100100000100000110100000
00010000010010001000001011100100010001110000100000000000000000100010000101010000100110000111010000001
00000110001000001000001001010001011010011110001010000100100100011001100000111010100100000000001000100
10100011010100000000000010001010101001010011100110010000110010000010101010001100000101000000001000000
10100010100000000000000001001001010000000010100010000000100000010111000001100000000001001000010101000
01100011001010000100010000000010101010000100001000110001111001001000001000000000101100000001000001001
10101110000110000000000010100100100011000010101000100000000000000000010110100011110001000000001001010
00000111101011101000100100010000111000001000010000000000000000000101000000110000100010101100100110100
00010000010100011000011110101000001001000000100000010100100000000000001001000100110010100001000000000
00010011100101100000000010000010111010000001000001100011011000010011010001100000001000100000101101010
11000011101000011100000110000000010000000000001000100101001000100110000100100001000110000001100011110
11000000101100001000001111100000001000011011010000000100010000011100011010100000000010011010000011000
01000001000100100100011010000001100010110011000000100001000010101000100101100000100000100011001100010
10010111001010110000110001010010110000100000111010000010000001100000110001000100001001100100000100000
00000100100000010001001010000010000000100001110011010000000001000001000011000011010000100011000011000
00100101000000100001000001000000000001010000110000000110001010000010000110010000001000000101000001011
00001000100000001110000001000101101001010010101000001001100100000011001010010011010100010100000011000
01000000000010000100000010110010000010001100101001000010000000001110010010000000000000100101101000000
10100100101000110001010101000010000101011010010000111000000100110110011100000010100010100000101010110
00000100000011000000000001100011000100011010100110100000000100001110001101000100010010100100001101011
00010100011001010100000001011101000000101010000000100100000110100000001000110100000110100101001000001
00110100000010010100001100000001000011110011010110010010000001000100100011010100100000010000000001111
10000000010000101010100100000001100100000100000101000010000100100011001000010101010000000100000010001
10100001101010010011000010001100000000000010010100010000100000101001101010000000000100001000100100100
01001010000010000000011100001110000000011010101101000000010000000010001100010000000110111100000001001
00010000100110101000100010000100101001001111000010000000001000100100110001110000000010000101100001010
00011000011001001000110001010110000000000000100011010001010100110000010011101010010000000010010000100
00110100100011001000000011001000111000000000000000010001010001001000011000000101100000010100100111001
00000100111000100000100001000010000010000010000001010000010001100001000000000000111000101001000110110
10101111000100000001010110010000000000011010010000100100000010110010111100001001101011010001101010100
10001001000000000000001000000010110101000011000001000011011000001001001000000101000010011001000010000
00111010000000101100001001000001101000000011000000100011101010001100000001000100001110010001000001000
10010110000000010111000000101000000000001001000110100000010000001000001000000000010001001001010000000
00010011100000000101000001000000010011001001011101110010001000001100001010001100110000110001110001110
01000001000001010010001010000000000000100100111100010001000101010101100000001111001010100011100101011
10111101101110000001101010000100001100010000001001010000000101101000000100000110000100000001000010110
00011000001010000000001000010011110000011000010100000001110000011000100000011000000110000001000001000
00000100001010000010110001010000010101001011000011000000101010010000001010011000000010100000100000000
10010001001000000010010101000000100001000010000010110001100100110001000010100011011100101000000101000
10100010100100100000000000100000100010100001110001000100001111000100000001110100001001000001000010100
10010010100010001000101101110100100100010010000010001000110010100100100000000011000011000010000000011
00100001011010000011010010010100001011100100110101111000000010000100010000101000000000100000000101000
01000110011100000000001000011010100000000010000000100111011110001010000110010100101010010000000000000
00001000000100000001010101001000010100111101111000101001000000110000101000100010100000110000100001000
00001001111001000001000010100100010000000000010010000010101001000100101100000011010000100001000000110
01000001001110110001010000000000000000000000000010000001010001101001000000110000000001000010001011001
00100100000000111110011010010001000001110100010001001010110100000110101010010010010011010011001001010
01000000000100010010011000001001100101001010010010110000000000001011110010011100010111010000000110101
00001010011101001100000100100001100110000000000100001001110000000000010100010100001011100100001100000
01001000010010001000000110101001000011000001000000100010000010000000000000010100000010010000100010100
10101010001001000100000010000000100000011010000001001000100100000001010001100110000100000000010000010
10001001000000000100011100100001000010101000001001101001000100011011000100100011101101110010000100100
01000111100001000000000011100100000010010000100000000101100100000001100001011100001000000000010000000
11010000001001000000000101011000010000011000000100000110110001001100001011000000000000000001101000100
00100001000110000100000010001000010100100001010010001100010010000110100001100101011100000101101000011
10100000110100000000100010000000000100000000010000011000100001011110001000101000000000000010110000010
00000000001100011100101100001000011010000000100000000000011010000000000001010001000010011000000001100
01000011000000100100000111100011000110011101011000011100010100100000011011000010101011011000010000100
01100101100001100100001001110100010000010101010111000000000000110100110010001100001000000100100100000
00000000000100010110101000100010000010000000000000000100000000000000011010100001100011010000000000000
10001000001000000110000011001001110011010000110000001111010110100000000000110000011000000001000010110
00010000001011000000100011100000111000011000010010000000011100010000100110000011011110101110010000111
10000101010001000000101010010000001110010001001010000100001000101000000010001000001001011100010010011
00000000001010100010100100010010001100100001100001000110010101110001001000100100000000000000110000100
00001100001100101100001001010000000010000101001000010010101001000110000001010000101010010101001000000
00001000101001000001000000110000001010100000000011000011000000000011000110100100100000100111000100001
01100000010000011100100111000001000000001100010001001010010010000010100000011010001010100000100111000
11100001000001001111001111100000010001001000010000000001001010000000010110000010010100101000100010001
01001001000010000000110110010000000100010010001000000001111000100000001000010001001000110000000000000
10000000110001000000010000001100101010001010000110100011001000100010100111100010001110000111010010101
01001000000110001000001010010110111001100001000000000001000000000000001011100111100100000111010010000
00000110101001000000000011100101000001000001001110000000001010010000001000000000000101000001000010000
00101000100010100010011100101010101001110100001100000110101010010000000000011000001000000000101000100
11100100110000010010000010010100010000011100000111001101000011110010000001001000000010000010000000001
01000000000001100000101100001010010100000101000001011010100001000100000000110000000001011101010000010
01100100010010101100001000000001011010011000000000000010010100000100010101100100000101001000001100000
00000000100000000010000000111101111011001000010010010100000100000000000000001110100010010000001000000
00001010000000011101001110101001100010000010100001011001010010000000000011000000100100000000000000011
01000000011000001101010010101001001001000111000010111011011000000000110000000000001100001110010110100
00101100110000001010010010010110000100000100000100000000100101000001011000010101100010001100110001001
10000000010000000100000101100010010001000001000000110101001010100110100001100011110110010000000011111
