10001000001000101000101000001101000001001000000001000100000000100101000100010010100100001101001000001
10111000000001011001000000011000100011001000001100100111000001010010010110101000011000011000001010001
10000000001001100110000000000111011100000100101000000100101010000110000000000000010000010011101010011
00100100100000000011000000101100110100000001000101100100011000000001011000100000000110011011101010010
00000100010010011010111001101010100011011010000100100001101001000010010001000011010100010000001001000
10100000010101000010001000010000001001010000001000011110100001000000101000111000010000001000001100010
10000001110001100000000000000000011000101000000100000000000001000101110000101000010101001100111000000
00001110101100001000011000000010010001100000011110100011001100100000011010001011010101001011010000001
00100000010101000100100100010100000000000011000000100010000011100000000000001001001111011100000000001
00000101100010100100010000001000000001011001100000101001101001011001000011110000010100110011000000010
10010100000100000000000100100011011001010100000000001100001011000000000101000001001010101101100010110
00111010000010100000000010001011010101010100000001010001000000110000011100110011011100000000000011001
00000100000000101101111000010100010001011000011110000010001100010000001001001010100000100000101001001
00000011001001000011010100000001100000010010000011100000001110000010011101100010110000010000000010000
10011010000000100100000001000110110000010001000100001000000100110110101111000100000111010000011000010
00110010001100000000000001011011000101100101011000101000000110101000000010000100001000010000000011000
00010000001000111001000011010110100000000000000100001000001000110001010000100100010110000100001110000
01000110000101000000100000011010000001000111010000000000010000100101001100000100001100010000100001010
00000001010101000001001000001001001110000000100000001010100110001100000001011011010011000000000001100
01110110100100000000000010000010000010010000000000000010000111000101011000111000101000000000000001010
00010110000001011001001110100001001010010000001001100000100010000100100000000011100000101000101011000
11111000101000000111101011110100001000010001000100100010010100001000000100101001101110000010010100000
10000000000001000000110010000000000000101000001000100110000001100011110010001000111101100000000100010
00100010100101001001010010100100010010100100100011000010100010111100010000010001000000110000000010000
10101100100001110101000011000000010100010000010000011000000110000010010000110011001100100011100001000
11100000100011000000010000010101001100011010100001000110001010000000011000011111000110001010011010001
00001111011100000101000001100011000111000101001000011010000011010000000000000110000000010100001011110
00010000000000010010001000010010101010010110000100100000000110010100000100000010011100000100000001100
11100000101001011000000101000000000001100001000101010001000000000000100110110010110001001000101110000
10100000000001001010100000000010000000001001000011000110011000010100001010110010010001011111101101011
00001001000010010010111000010000000101001000001100000100000000000011100111000000010001110000010000110
01001100010000100000110111010100001000000001111110000011000000110010010110000010010110000010000000101
00000001011101001001000000010010010010000011000000110000000000010100101010001110001000010000101001101
01100000010110011001001001010000001000001100001010100010011000000000000011001010101001000010001000000
00101000001010010111100001001000000101000010001000011101101001010000001000010010100000001000000000011
10010000010001101010001110000110010000000100001111110001010000000100000001011000101010001100011000000
10001000000000101000000001100001110000001010010001001001000001100010111000000000010000000011010001000
10000100101110011101101011110110000101111000000100011101010010110101001001100100011010011100000001010
00100000001000001101001101000000010000010000100000001101000100000010000001100000010110000100101100001
10100011000000011000000000101001000101000010001111000110000010011110100000100100010010111000100000100
10000000000000000010000101000000110000000100000100100000000101000000100000011010000000100000000000000
00000000100000011100000100110000111001000101001111100000010000010011100111110100000000010010000110001
00101010000000000001000001001100001111000100000110101101101000001000010010010010100001100100000000000
10101000010111000110000000001011000000000100011100101000000000100001010010000001100111000110100100010
10110000000100010000110001100110000101001000001011001001110100100010011001110000000001000101010000010
00011000101100010000001000000000110000000001100100010000000100001001010101001000110001110000001000000
00000110000100000001100001000001000000011010000000000001011000000000010100010110010011000000000010000
10001011001000000000000000110110010000000001011011100010000001000000011000000010010111101011001011010
00010010110100000010010011011000000000100100100001001101000001011000010000110000001100000010011010100
11001000101000100100101000011010000011100000000001000101010100010100001000100110010100000111001001000
01000110001010000000010010001100001000100010100011001101100000001100100000001100101000000000100110000
00001001000001001100010101100100000010101110001010010001001111000000000001001100101010100110101111001
00010000010000000101010010000010001010001100010101001001000010101001100110101000010100011011010011101
00000110001101101000001101000010110100010100000001100001000100001110000110101011000010011000000111000
01111000001011100000010000010010000010110011100100001000011100000001000111011000101010110010111011110
01110011010010010100010000000111010100110010001000000100011010101000001000000001000010000000101000010
00100000000111000010000010011001011000000011000000010001010000100000000100001100010000100010010100001
01001000001000010010001000000001101000000101000001000010000100100001000101001100000011000000010001001
00000000110001001000010100000100101001101000000111010110000000110001000000100100000100011100000100110
10010110000011101101000001000001110001100010110000000010001100110110100000011000010000010000001010001
00000000000000010100110000100000010000110000000100000010110100001110001110011100000001011101001110100
01001000100010100100011100110000010010010011010111000001000110110100011010001000110000000100010111000
11110010000010000000000010000001000100000000110110100100100010000000100000000000000000000010001000100
00101011001100010011010110001010111001110010100100001000010011000101100000010100000000010000011000001
01010000010110100100000000100010001000000110100000101000100100001110000100000000100100101000000000100
00000101100100000100011110000000000101001010000110001010100010101001000110010000101010010011111001000
11010000011001110001000100000001001010110101101010010101000000011101000000000000011001000000010001101
00010000001011000010011000110010000110000011000011000101100110001111010010100011000000000000000011000
10010000000000000010010001000100000000100010011011000011001001001000000010100000101000101100010100001
01101001000011110011100001000110010010010110100001000101001000000000001010010000111010000100000000101
00100101000000100100011100001000000001100101000001001000110000000100011001100000010000001001101100100
00110100010010100000001000100100000001000000011010000101101000000000001100100000001000100010011110101
10101010000000000100000101100000010100000000001000011000100000110010000000101011001100101100000010001
10011000001011100000000001000000100000000010101100100100011010000111011010010101010100010000100110000
00010000010010000000110010000000000001000000000000001001011001110010100100110000000010110001000001010
01000000001000000000000011001000100100011000001001011000001100000100000001011100110000111100000111000
00001010010100100101000001000010000000000110100000011010100001000010001000110000001001001010001010010
01000100101010001000011011100011110101111000001000000000000010010000000001000010000110100000010001100
01110001001011000101010001000100100000000010000000011000001100011101110010000001011000110101011000100
10010011100001000001101111100000100000100100001100001000100001000101011001010000000100010000000110101
00010010000100011000110000011000000101001100110000000100000111000011000100001000011000010001000001101
00000010100100100000010000100110000111000000100110000010000001001111000000010100100100010000000100100
00000100011010000000101000001001010101010100000001110100111010000000000001011010000100010010100010000
00000101010110000100000100100011000111000010100001000010000010000000000000000000101110000010010000100
00000000000001000000101100000001001000001010000010000010010000010110010000110110001000001000000010000
00000011001011100011100110100100100011000100100100000110011110100001100001000000001000111100100100100
10000100011010010100001001010001001000010000001011100011111101110000100010001100000010000110110000100
00110001000000000011001101100001010111101101000001100001111000001010100100000100011100001000010001000
00111110011111100010100010000100000010101000001001010000100011111001000000000011010111000101000000101
01110011000010000000000000000100000001101001101001011101001000000110001110000001001000000110110100101
11111011100101000000001000010110011101001100000001011110101010000000000100000001100100011010100100000
00010000001000010001110001011000001010100000001001001010001110010011001000000000001110010011110000000
10000110001001111000000000000000010000000001010110100011111001000010100000011101000000000100000100101
10010000000100110000100000000110111010000010100000011110101001000000000010001010010101111001001101100
00001001011001100111000010101001000000000011000001001100001111000000100100011110100100110010000100000
01100000100100000000010000100000101001001000001000000000001000000000001100100000010000110000110011000
00100011101110010100010100001100010100000000000000010001001101011000001010001010110000000000101000000
00010100101010011010011000010000001010000001001000010000000100000001000000010100101000110010101001000
00011010010000000000000001000001100111001011100101100100000000001000110000000110110100001011000011011
10000001110110110010010010000100000000001101110101001000100001000000000001000000110000101000101100001
00001000000010000010000110110000000000110110000000100000000101011101001000010000100011100000011000000
