01100000001111010111110100001100000001000010110011010000001000000001101100100000100000010111000010100
00101000001000001010000100000011100001001000000010000110110101010000001101100011000000000010000010110
00001101000010000100110000100000000100111100100000011001001000011000011100010001001100001000000100000
00000000001001010010010110000010000000010111100000000001000011010101000010010000000000000100001110000
10010000011000001001001000101110000000000011110001000011100000100000101000101001001000010010000010010
11110010000000110101010001011010001101001011000100000110100000100000000000110011110110110100010000000
00001010101001010001100100110001100000011001100001000010010000011001111000010000110111000000100010010
00000110011001000010001001010000000000010110000100000101100101100111011000010100011000011111000100101
10100000101000010000000000000000010011000101100100001001000010000010000100100000011000000100101010000
11001000000000000001000100001111010100000000000010001100010010011000100000001011110100100000010011010
00001110000000100001000010011100101100100001100000111000100010000000110010000011000100000100000100000
00000010000101000110000000000011100000000100010100100100001000001000000001000000000011100010110000010
11000001100100000000001100010000001101000011100011010011001010000001011100001100000100110110100001100
00011001100010000001100000000100000000000000001011001100010001000100001001000010001000001010001111010
00110101000000000100000010110110010000100000100010011101100000010011100100000011000100010000110001010
00000111110000000000000001100110000000010001001011110000110000000011001001000000000100000010010000110
01000010000000000000100000001110110010011110000001000000001000001100000000100000000011100000000000100
10010011001000000011000010010110100001000111100001010100010000100010100010000110010000000000000000100
01111011100000000100000001100010001110011110001010111101100100000000000110100100110100000000000000000
10100000100111000100110100110000000101000111001010100110000000010000110001110011100101000001001010110
00010100101111001110011011000110000001000110100000001001000000000001110000010001011010011010001000100
00000001110100000000010000000001010100001000000010110010011000100010001000110010011000010001000001010
10001000100100000010110001011110000011100100000010111011010100000011111010100000000000000110111000010
00110010010010001101001000100111011100001001100001110110010000011000101000101000011100001110000000010
00110100100100000101001010011000000011110010110000000100000010100100100010101000010101000100000000010
01010010100000010101100001110001100010011100001100011000001001000010001110010100011010001001100100010
00000000010010011100000111000000001010111000001010011010001110001011100111000010000000010000000010101
10010011001000100100100010010000100001001100000101010100000000000000001001010101001101101010100100100
10100000110000100001110010001001100011000111110000011000010000000100011011001100000000011101100010001
00101010101010100001001001010000000000100000101000100000000101000000110010101110001110110100101100000
01001100000000010001110000000010011000001000110101100100001100000101000111000000010000100100001100100
10000000010000010010010001011000001000010001010010000010000010010010100100000000000000100101101010001
00110001011001010000100000000000010100001000000000000010101100000100010011000001001011100001000110100
00001010000101000000000101111110010001101010010000100000000011000000100001110000100000011000100001000
10000101100100110001010000000001000001100001000011000110010110110100000000010100000100001000000000010
00111001001010000001000000001010001000101100100010001100000111100110111100001101000001110000100001000
00011101011000111000100101100010110011100011100110110000100000010000001101000010000001000100000100100
00100000001010110100001110110111010000000011110000000011011100000001011001101000100001000100101011011
11010110000000000010010001000110000001010011110010001110010100101001011000000010100000100000111000000
11100111100000001010111100000000011001000000000011010100010110000010000100100000000011001001010000000
01000000010000000000000001101100111100101101000000010100010101110000010010010101101000010001000000011
10001000010100001001011000010000010001000000000001110100000001000011010000101100000111001000000000010
00101110101110000001010000101001000001100011000010010010101100000100001000010100110110000000000010000
01000000000001111001000011000001110100000000000010110010001000010000111010000000000010001011000011000
00001000000000110000110000001010010110011000000101001000101100101111000000000001000010101001000110010
00001011000010100011011101011000011011010010000000000000001000010000101010010000100010000110011100000
00101110111000001000001000001000001000000000010001110001001101001000111101001000000000101100000110000
00000000011000100101100000100000000000000001100011000000011010010000001110001001101000000000010000100
11101100000000001100000110001100010000010000001100001001010100100101100000000000000100000000001000000
01000010100101110001010100100111000000100000010100000100000010100010101011000000011000000000100000010
00010101000111000010011000010000010010000110000101001101000110100110010011000010001110001101101100010
00100111010001010110010010010000100001000110111000000001100000010001000000000100010100110110010001100
00101010010010010001001100001010010000101010110110000000100110000000010001100010000110001010010000001
00110010000000100000100001000000100000010001000000101000100000100000000001100110100100100000001010101
10010100000101000010000000000000100100000000100000101000001010000000100000000010000011000000000111000
11001010111001000100011001011000110111001000000110000100100010000000000100111100101010000010001110101
00001000111010111001101010000000110110000010110001000000010101001000001010011010010010000111000010100
00100100001011000000100000010000010001111000101000000001011000001010101000101010100000010000000100000
00000011000001111011101110000000001110000100001001001000100101010100000101100101001000001000011001000
00010011001011000000001101001000100010000000001011000100011100000000001001010000101000000001100000010
01001100000101110000110000000001100010110000101000000010000001100000000011100011111000100001010000011
00100000001001110100010100000100100010010000000000000001000000011000000100011000000100000110101000000
00111000000000001000011111110011000110101100010000110001000000110001110110000001001100010000001000110
00000010001100000100100000000101010000000000001000101000101000000100001010010110000100110010100001111
01000000000101100000000001000100011010110111010001001010010000111110000011000001100101101101001001000
11000011100001100100010010000010100101100001100001010111000000000000001100000000000100110011000011101
01100000001111001000001001011001001010001010010000000000001000001000000000001011000010001000010010100
01001001011010001101101011110000001000101000100000110000000100110100100101001001110100010000100110101
11000010000000000101000101000001000001011000000010000100000000011100000100100000000001101001010101100
10000010000000001100000100100010010100000000110100000001100001100010110110000101100011000001000000100
01100000000000000000000111000000010000010010100010011000000000000111001000110010000100101000000000000
00101010000010000000011010010100000010111001101000001000110010010100100100011000100100000100000010100
10000010110001010111010011000011000100101101011010001000010110000000000101101011011100001100001010101
01100001010000010000010000001100010001000110111000100000010000000000000010011100000111010000100101000
00101000100010010101111001011100100101001100011000011100110110100110010100100001000101000011110010101
00000001010011101000000000100000000101100100000001000000001000110001000001001010000000000000010000000
10011000010011101011010110011011011001101100000100010100001001000001110000000000000010100000000001000
00110000000010110000010100010010110100111100010100011011001001010000001000100100011000010010000010010
11001011011000101010000110010000000100110010100100001110000110000011000010000000100010100101010101000
00011010001001000101001110001010001100111010100000000010100010000100101010100110001100000100110010000
01010100001000000001000000000100001100100000000001000100100001001000001000010101001000100000001100000
11100001001000000001010010010100100000000001010001000010000010000000000000000000111001000000010010000
10101010010010000000101100100100111001001000100111011001110010100000111000111101000001011110000010000
00000111010100000000000001000100001001010010010110010110111011101010000000000001100001110011001000000
11100010000011000110100100001000100001010100010011000000100001001110001000000001000111000001101010100
01011000010000000010011010000000001000000010000010110100001000000001100001110000000001000100100000000
10000000000010010010001000111000000000000010000101000010100001000000101000000000010000000000100010110
01101001001001110011111100000110010001010000100000010001101010011010001100100010000000101110000000010
00010011000000000000000010110000001010001100100000000001001111011101000101000100011010000011000010000
01000001100000000000000010010010100000001000101011010011110100000001100000110010001010000000010000100
00111001001111100000000000001101010001111001000001100000000100000010001000010111000100000110110100100
01000100000100110101100101000011000001000000100010010100110010010010001010010000000000111100000010110
01010001001101000000010110000000011000100011000000110100010100101101001111101100000000101101010001001
00000010000011000111010001011100000100001100000010000100111001000000110000010000110101011101110010000
00010100100010001000000000000001000001000110001001011100100000100010000000000010011100001100001000100
01001010001010000111001000010111000001001100001001010010110111010000001110011100001001011000000001000
11010100000001001001100011010000000010101100000101100001100000010000101100010000000010011001000100100
10110010101100110010000000100101001000000001000011011000010110001100111100010000000010100010001100011
10000010010001001000100001000000010010100000111100001111011001010110000000000000101100000110000000010
00000101000001111010100010000001001110100100011001001100000010100000010100001000001000000000010010110
00000000001001000000000011000100000000101010001001000001010100010101000000100001010001000000101000110
