00010000110100011000010001010001000000100100010110001000100001100100100110000001000010001101001001100
10100100110110010010100101101111001000011011010001001000011000000011010000010000010111101001100011010
00100011001100000010111100010000000110010010000000001011000010010001000000001111000000000000101000010
00000111010010100000000010010000000001100010001110010011100101000101001000100000100100001001010000000
00100001000000000001000000001100111110000000010001100010000010110111000001011000100000100001000000110
00001000000110011000111000000010000010001010000001000000001011011000000011000110000000100111010001111
00001111000101001100100010000000001000000000010000000000110010011101101101000001000000000010001101011
01000001001101010000000001001000010001001100000010000000000001001010001000101100100111000000000101011
01000000000100000010010100000000010010000001101000101000000011110010100111011000000100100110100000010
01111000011010101000000001000000110100011010001011100010011101100100000001001001010010110001100001000
10000101000000011000011001000001010000011000010010000000000010000001000000111011001000000010100110100
10001000100000000000011000001100100001000011001010000010010111000110001000011010110011010000001000000
11001001001100101111110000110000010000101100000000111101001000010011000100000001100001010000000000100
11100000011101100001001000001100000000000111000000100100000010000010110000110001001000000000100101001
01000000110010000011010001010111000101000001000000010100000000011011101010001001100101000011010000010
00011000000011010000110010101000010000000010010000000001001000101011100001100000000001110010000001010
10110000100100000000010001000010000001010000001000100100000010001000010000100010110100010010000001000
00011000000010011010000011100010000000010111100001010000010010000110100000000010111100100001011100001
11000000010100001000100000000010010110000100101011100011101001000110000001011001010100001000010001100
01111010000111000010011101000100000110000100101010000001000001000010110000000000000000100100000001011
10001000001110100100000101100000011000000100000010000000001010110000100010101110001000010100010001100
00000001010010101000010101110000000000001110001100101000000101001011001100101011001100000000100010000
01000010100010001001000000100000000100101100100000000110110100000000000000001010000010111001000101000
00000001000001100010011000000011000110000011110100000000001001100000010110100010111001110000101001101
00110010111000010000010000000001000000000010100100010011111101010011010000000010110000001000010011101
00101000101000000000100000011000000000000000110100000010001001000010100001000101000011010100100010101
10001000001000100001110011101000110010001000011001100010000010110110001011000000111110110010010001011
10101011000000011010110101000101011010010101001101001000001001011100000000001010010100000011100000011
00000001101101000001100100100100000010110000111000001000100100100000000000011000000100101010000001001
00100001001011000010100000010010001100000000101100000101000101000000111001011100010000100000010000000
10010101000011010010010000110000010111000000000100000011101000101010000100010110000100010011011010111
10100001000000110000000111010010010110000001100000011000001001010010110011010111000000000110010101000
10001000100000000000001011100010001000110000001010010111011000001100000100000101100000000000000100011
10001000101001100000000000010100001101000000010010010000000000100001111110010000010011000000010111010
01001100000000100100000000100000000000000111110011000110001001100000100010001010001000001001010000000
10100000000011000001010010111010000000010000000100000110000010000010000000000010100000000000000100000
00010001111011001100000001001000110000000001110100000000011100010001100000010000000100010001010001010
00111000010111110101001001100110000100000110100110000100000000000100001001001100100000000001011010100
11011010000000011101000000000111100001011010000000101000000001000000100100000110000100010001100010100
00011100110100110101101001110010001001001001110001010001001001000101100011100001011000000100110100000
10000000000010000010010000110001000100010000100110101010100111110100110111011110110110001000110010000
10000001000001000011100000000101011010110010001101000010001000001000000000000101100000001000110000100
01101110101000000000011001001000000100101100000010011001000100001000000000111100000101000000010111000
00000001001001000010100010000010000101100101100000001001010100000100100100000100000000001011011000001
10100000010000100000011001000011001010000101001001100000001010100100101000110001000100000000001100000
11101001000000100001100100000001010000011011010000100010111001000000011010000100111100000010010011101
10100000000100100100000000100001010010010000011000010000101000111001100110000000110011101010100001000
00001111000010010000000000000010000101011001000000000110000100011001000000000111011001110000011100101
00100001101101100000011100000000101000000100001011010000101101111101000110001110000100110001000010100
01001000000001000000000000100000100100000000000000001000000000010001000010001001001000010001000000100
01111001000000000111100101010100000000010101000000010000110010000101000000011001000001001011000001000
00100001000001000110010100010000010000100011100000100010010000001010000010100101100000000001010110110
00011000101010101100111110000101100000010001000011000000000001001000011100000010010000000010110101101
00001000000000001010000000001010000100001000101000000001001010010000001011001001001001000001001001101
10010000110001000110110001010011100101000001101000010000111000010100000011000001001000010100000000110
11100100110000010000100001001010110000100100100001000000011000010011000000111001001011000110010101000
00000100100100001001000011010000100001110001100001000000010010100101011000110011010011111101000000000
00001000000100000001001000100101000000010100000000000000001000000111011100100000000010001000000110000
00000100010010011000000000000000001000001000000001101000010000110010000000101000010001000000000000100
01000101000010110001000000010000110100100000011110000000101000010100001000100010010000000000000010100
10010001100100001000111001100100000000100100100101111100000100011110000001110010111000001100001000010
00001001000000101010000010000011000010100000000000100000010100010000010100000100000000001101011011000
00110010101010100011000111001001001000000000010000111101010101000110000001000000001000001111000000010
00001001000000010000000100000100011000100111001110010100011010000111100110101110000001000100111000000
00010011000000000111000010001011000000000000010010001000000001001000100000000000100010000010000110100
00000010010000001000110000000010100100010000010001011110000000000000110000100010001100010110010100110
00011001000000001010110010000010000010000100001100011100110000010001110010000000000011001110010110111
01001100101000010100001010101000110011010101110100010100000101100010000100000000101000000010110001000
11101100000000100011000010110001100110001001000010100010000100010000101101000000010100100011010000010
01000100100000000011001010100110100100110100000000111010001000100010000111000100100000100000100010101
01100010010000000100000010000001000001001000000010010111000111111000101000000110001100000000101001010
00100110101000001001000001000001001011000001000000101000100110001100000000010100011000010011000000001
00000110011010010000000011000000100000110001110001010011000000101010001110000010011010001010010100000
00000010010000001000111000001101101000000011000000110000000000101000010101011100000011000001000000101
01001010000001000100010010100110101001100010001010100100100010000000001100000000101010100000010101011
01000100100010001010101000000000001001100000000000101111100011000000100000000000001000011101010010000
00101000001011101000011000011101000001101000000110000101010001000000001010001001000100110100001011111
01000000010000100010000000000110000000010001000011000000000000001101010000100011100101000000001000100
00000110000000000000000000000000000001001001010000010010100100001100100000001100100000100000010000100
10111010010000000011010001000000000000001101010010010010100101000000000011010010100001001000010000011
10010000010100001100000000101001000000110000111111011000001001101110100010000000100001010100101001101
01001010000000101000000000101001011101000010101100001100000000000010010000000011011001001011000000010
01000000100000010000001000000010011001000011100001101000011001110011101001000000000000100010000011100
01000110010101000101100000101100110011000010100001101010001100001110110000100100010000010000001001100
01000000000000011001000100110001010100000010010001001100000100000010001000000011001010000000101000000
00111000001000000101111011000010000000000101011100010111110010011010011011010000000100001101011110000
00000101000011110100010110000001000101000010000010010000000000000000101000001100000100100001100001100
10100000001001010010100100110000001000110110011000111000001000111100011000001000010100001000001100100
00001000100100010000001001000000000000110000101000010000000101000001100001011000000000001001100000010
10000100010000001101010100110001000000100001001101000000000000011110010001010000000000001111001001100
00010110000100010100000000001110001101100000110001010000100100110010100101010000010100101110011000000
00010001111100000010000001100001000001111000000000000001000110101110000100011001001010000000001000011
10000000101110000000001001000101001111010100100000110000000100000100100001010101100010010000001101000
00001010010011000111100101010011000001011101010010100011010001010100001010100111000101100000001010100
01100010000100100010101110101000001001100010000101000100010011001010110010110000010101001101001000010
00100001000110001011000001000000010000011000001010101010000010000010001010000100100011000010010101010
00110001101110011001011100010000000000000000000000001000000010111001001010010000000101000000000101001
01000000010001011011010110010000000100000110001000010000110100000001100110100010000000101100001001000
01010101100010110010110000100100010001100101000001100100000000100001110101100001100101100101000110000
00001000000000001000001010100111001101110010010000001101000110000101000011000100000010100100001000101
00000000000010010000000100111100000001001000011011100100001000001110000100000001001000000010000000001
