00010001101101100001010000110000011000100010000110001110001000000000000000001000010100010001001010000
00110001010001001100000001010000010000101101001000100010001000100101101000101001111100100100111101100
01000110100000001110100000001000011001111010110001000110000000010110101100000001000000011000001100110
00010001000011011000100010000100110000010000000111001110110000000100101100001000100001011000101000000
01111000001000101110001010011100011000101100001010000110000010001000100000010000110011110100010000100
00000000000000101000011010000010000100010010010110000000000000100001000011110010001010000010100100101
00000000000110001000010000010100101101100000001111100101101001100000000100000010010111100000010010000
00000111000000101000101011000001100000000111111100110001100000000000010101111010000100110110010010001
00110100000011000001000100100110000100001010010000100000001110000011010101101000000100010110010001001
00100000000110111000100001001000101000000110011010010000010001001001000010100000000000000100100000001
01000110001000010101110000010011001011001000110000100000010100100010001100100011000001000101111010000
00100010101010100000010010000000101010001100001001000011000111001110000101110100011100001000001011100
10100011000001000010100000010001000010111011100010000100000000001000000011000101011010100110000010000
11000010000000000011100000010001000001110000000100000000000001010000000000110000001100010100001110100
00000000000110110010001000001000011011000010010101001001010000000000100100000000010100001011001010000
00101001011000101101100000000000010001000010001100001110000110000111000100001111000110110001001010000
01101010001011100100000000101000111000001000111011010000000001100000010000100000100101110010010000000
00010000001000000001010010001100010010001001010000000100000010101010100010000101100000101000100010000
01000011100000010000001011101010000000001011001100000000100110000000000001111101100100000010000011011
00010010000001011011100100000000001000100100011010011100011100101000101010001001110011010100000010000
10000000010001010001010010000101000110101100000000000000110110010110001100110110001000001100100100001
01100001010011000000010110000000000001100000001100110110000001000010000000000010000001011110100101000
10010100000010110000001000000011100001000110001000100100101011000010001000010001100101100001011001000
11010001001100101000110000101100010101100011100000010000001000100100101000000100001001000010000100000
01010010100000011100000000001000011001101000110000101110011000100101001000000100010001101100001101100
00111001101000011000010000000001000100000000001001100101110010000011001000000100010000000000000000100
10001110001110000000110000000100010000001000000000000100001000010001000010010110001011110011000001000
10000101101101110010011000110101010001000110101010101000001100000000100000000000000100000010111000000
01110001001010010001100100000000001000101110100010000000010001101010000100000010100100000000111101101
10000000101000000010000101001111011000111011110110000000011101000100000000000010000011000100100001110
10000100000100000000001011000000100001100000010101000001001000010000000000011000010001110110000010011
10000000011101100010010100111100001100000010001000100000000000111011000000011001010001001000100010001
00000000010010000100100100001001000110101101100010110001010010100000001011110000100000000010101110100
01001100001001000110100000001001000101000000000000010010101000000000001000000111010000000101111001010
10001000101010001001001100000110000000100100000001000000110001001000001000001100100001001100100011000
11101011100100010000001101110000000100011100000000100010101111100000100010000010000100101000100000100
10100001000000010100001100011010011000000000000001011000100000010011100010001001001000000100011100000
01000010000110001010000001011100001110000000000110000001000110000110000100000100101100000000010100001
00110000110000100100000000000100101100000010000001000001100001000101111010100000100100101000001000000
00010010100000000010100100101000011000011001001100000011011000010000010000010010010001010000000100101
00000001000011110010001001001001100101000000010010011100001100011110000010111111010011100110110000010
11100110000000010011000001010100100000001000001100100010010010000010100000111000001010001001001001001
00010100000100010100110100101111000000010001000000000010001011100010010000000100000010100100100110001
10100010001101100000000010000000000000000010000000001110010011000000001100001000000010110000010111111
10100011100000000001000110010001110000110000000000000000010010000011111000010111010001000010011000110
10111001001000000010100110000010000100011100000110100001101001000011001100001001000100100011001101000
10010010010000100100000001000110101100000001101000000110000100101111111101000001001100010010010000000
00000010000000010000000000110100000000100010000001110000010000010010010101000000000000010010000000001
00101011010001001100000001101010100100000000000010101000011000000101101000101000100000001000100100010
00000110111001100010000100010001000000010110100110000000100011000001000110000000000001011010001110001
11000000001000000011000010100100000010001000010000100011010010001011000101000010110101100001101010100
10001010010100100010001010100000001000111001000000010011000011111100010010111101100010000101001110010
00001000110000000100000000000001000100000100000100100011011111000110011100000000011100000100010001100
00010001000000001010010010011000000011010001000000011100000001010000010110010001010000001101000101010
00011010000101001000010110000000000010100101001001100000001001000000000001010000011000000110001100000
11100011001101001000001000000000001000000000110000101000011011010000000001010110010000001110100100000
00001000010100000001000010100110011101000001000110010100100111110011000011100001000001010000101001000
01001010100000001001111000000000001000111101010100010101000000001010000101000100001010110100011001000
00000001000000001100001100100010000001100000000100100000000101110110001010000001000000000100101000001
00101010100101101000100000000011000001101100110100000111111011010010100000000010100000110010010001001
10010100011011010010010011100111001000110001000000000000001110001011001001000011110001000001010010110
01100001000100000000000101001011010111001010010000011010100100000000001000000010100110010100010000001
00011000010010100000010010100001100001010000100000100000100000100010010001100000010000100011010000100
00100100000000011000010001000000000011010100000010010000100000100100011000001001001000000000001101000
00100010100010100001000001111100000000000101000010001001000100011001010010010111000110000101001110001
01010010000000001110000000000001100100001001010000000001001000110100001000000000101010001100001001000
00010010010101111001001000000110100010000011100100001000110001001100000010011110101000000000111000000
11001101100010000001010010000010011011000000000100000100000000110000111000000000100010000010100001001
00010011110001100000001000100100100010000010000111000001100010010000100100110101000101000000100000101
00011100000000001101001000000010000100000101010010110100100000100010000010110000000100010001000000001
11000000110011001100000100001010101000000101101010000001100000000111000001000100100100010100001000000
00000001001000110000000001100010010101110011010000001110000000001100001100000110010010000000011000100
00000001000000000000010100000000010000000000010110010000000000010010000001010001000111001000010000000
01100111000000000000000101001010100000100100001010000100010000000001100000110010010101011001000100000
10000111010100000011111010110100101001001000000000000010000001001100101001001110010001000111110001110
00100000100000000110011100100000000000001000001010111001000001101110000000000000000011001001000111111
00000000001000101000000000000000010010010100100000100000011011100001011000011010110000100011000000010
11101101001000010010000110000110000100100000100000000100110001000011101110100011111110011010100100100
00001101000100100000001000001001000100000000100000110010010000000101010100000000001010011011100000010
01011000001100001011000010001000101110000100000010101000000010100011010010000000000100000000010100110
01010001100100010000010101100000100000001000001000101000000100000010000000000100001000010110001100000
11110100011000001111010000011010000000010010010001000010011001000000000001001000000100001000001100000
10000000000000010000110010011110000010000100000000001000000000000010010111100110101001000000000000000
00000000000000000111011000000011000100100001011110001010100110011000110100011011111101000010111000100
10000010000000110100000011101001111000001001000110100001010000000101100011001001001010000100110111010
01101000000001001101000000010100001000000001000110001010100100000010100000000010000000000001000010010
00001010000000101010000000000000000000000001000111000000111100011100000001000100110001000100100101000
00000110001001100001000101100110010000101011111000100000001011100001100010101000001011011010111000001
01110010101000111101100000101000010010000000000000000101010101011000011011010000100000011100010000000
11011000010000000010001100000010010011010001001001001001100000111000001110000001001100110000001100000
00110001100001001000000010000101001100000001000100000100000010000011001001001010011011000001000000100
00011000000000011100010011100010100000000100000000101101000111010000101110000001000000100000000011110
00010011000100001101110110000000010101000010100000010001001110010001010111000001010001000000001000001
00000010010100011001100011001011100000010100010100101110100100011100111101000010101000010010101010000
11011001101010000010110101110000001010001100010000001000000011010001100000000000011001010000011001000
00000100101001001100001001001011000001001000000000100001011000100000100001101001001000000000110010000
00000000101000010010100000100100101100100001000111000000000101100010010100100000100000010001000101101
11110011011001001110100000110000000100111000100101010000000101010100100100001101000000010111011100000
00000001011000110110000000001001110010000011001100010110100010000000000000010010000010100000010000101
00000000101000010011001000101000110101010000011000011100011001100001011001000100001111101000111011000
00101010001000101011010011000000100000010000001000100000010001011000101000101110010000100000101001010
