01100101000100001010111010001010010101001010010000010011000010000110010011000001011110001011000010000
10001010100001111000000100000101010101100001101100100000000001000100010010000010110000010011000100011
10000000101000000101100100001101110000000010001000011000000000011100101001010110000100001010010000000
01101000010000000000100010010111100000100000001110010011100101010000000001010100100010000000010001101
10000011010001100000100101000000100011101001001000001000000110111110010010010000001011001010100000000
00101111100100010100000000101000000000000001010010001010011000000110100000000000101100010000111001110
00111000000000110101000100110100100000101000110010000000000010100001000111100001000010000000010000110
01100011000000001111010001000011100111000010110000110111000001110001000000001000010000100010001100101
00010100010000101000010000100001001110000110000010000100000000101000100100010001011000100110011101111
00111000001110110001010000110000010101001110110000000100101001001010011000001001110000000101000011000
00001110000000011000000100000010100000010001001111110000100110101000010010101001100000101010001100001
10001110101000000100000000000000010000011011010001001000110111000100011010101110101000110101000010001
01010010000000001100110000010101000010000000101010011000000100100011000010110000001000010010100010010
00000100000001010010000101000010001100011100101100000001110110000000000001001001100011001001000000110
00000000011111000110000011000100001000001001000000000100101100001000011000101100001000010000000100100
11011000010000110100100100000000000000001101111101000101010110001100000101101100111000101110001101000
00000110000000000001101100000000001010000001010011110000011001100001101001001010000001101001110000001
00110001000010100010000000101110000110110100000000011000010011011010000000000010011001000001000000001
01001000000000100000010100010000000001000000010000001000000010000010000000010101100010000000000000010
10100100101001000000000010000000000100010001000000000100011101110000010100110010000000010000000000010
10010000010000000011010100000000000010000001110001010000010101100000001000001010010101010000110000100
10010001010001000001001100110001011010010000111000010001110001010000100111000100011010100000000010000
01100010000111100100110000001001000000001001110100001011000101011000011000101010111100100100010110010
00100000100100001010101000101000100110011001010000000000001001101100111010001110000100101100110011000
01001000000111010110010000010000010001101000110010000001100010000000010001010011001001000000000011000
10101001100000000011011101001101100010100100010000010101010001101000000100100000000100101010001000010
10000010000001001001000000101000110000000010010000000100000000001000010111100010100100100101101000101
00110101010000010001100100100010000001100100001010110001101000100001011000001110000010110010100000000
00001010000010000001010000101000111000100010110000000000010000000100010010001001000001010010001100100
01000000110000000100010000000010001101111101100000001101010000100000001001001010100100000000000000001
10001101110010010011000010010010001100100000101110010001000011001001000010001000000000010000010000000
01100100000000101111110001000000011000011001011001000011001000011111010000001100110111101101100101000
10000010010101101000000101000011000100000000000100000000001000001001000010000001000111100000101000000
00001110000000000010000010101000000010010000100000010010011000001001011010000010000001010001101001001
00001001100010010010100000100001100111000001000001110010001000000000010000001000001000100101010010000
01010010011000010110010000010000100100000001001110000000000001111100000000011010010000010010100101000
00011100010111110010110000000001000000000000111000000000000001011000011000001000001000000011011010000
11011000000000010001001000000000010001010100000001100010000001001001001001000101010000100000001001000
00000100000101001100011001000100000000100101111000010000000000010110001000011001000110011001100010000
00000000101001110001010000000100000100000100100000001000111001000000000010000001001011000000000111000
10011100010111000001111010000100000000001010000000011110100100100000000110010011000110010000100000000
10000011000011000001000111000001101000000001000000101000110111110010110100000000000000000010010010010
01010000000000011011000100010100000100010000010111000010001100010111000001000000000000110000000101011
00000011001000110000001011100100001110000010100001010001100000100010000000110000000110000100000001010
00000001000111100000000010010111001101000000010001001001111000001000010001010011000001000111100010000
10010010000010000000010100101101000001100000100000001001001001001100110011001010100011000100100000000
00000001000110011010000101010001010000110100110100000000010001011000000010000000000011000000000010000
00001000100000000101001000010010000001000010101100000010110001001110001001011010010010000011011000101
11100110010000000000010100001011001000010001101010010011001111010000000000000000010001001001000000110
00010010110100010000000110100010000000000001000000000100001101000010010100011000001001001010110100000
01101000100000100011001100101001101000100011010000000010100000000000000100000100001101001000010100011
10000010010001001110000111111110011010000000110100011110111000000000101000010100011000100101001111000
00110000000000000100100000000001000010000100001100000010000101010100000000001001010111000000010100001
10010000110001111000100100000000111001110000001001000111001001010000010000100100000000010000011000100
10010011000001000001011010010010000001000100110000000100100001000010010111111010010001010101000000001
00001001100010000000000000000000110000001000011000100100100100000010000010101011100100010001101100000
00000011000101010000000101000001110011100000100000000100001011100011000000000000000001001000100011000
00001100000000000100000010000000010011000101100100010010011100001000010000111100011000111000001000000
00000010110100010000001011000001000000000001100000000010000011010001100000010101001001010001001000000
11001000000000000101001000110110000000100000000000100000000101000100010001100000011000101011010101001
00011000011000000000011110100001100010000101100000010000100000000001001000101100000001010001010010001
11000100001111101101010001001010010001000000000001100110010001000001001100000000001110100000000100110
01000001010100000101001000000010010100000000001100100001000101000100000001000101110000000110000001000
10001001001000100110000000000000001100000010001000010110010100010010010000000101000001100010001010001
00110000001110000011001100010001001000110111100001101100100010001011110110100010000010111100011100100
00000000001000100010101101001100010101000001111010000110000111000000000000000010010001001100000010110
00000000100010110010100010101111110010101000001001001011100010001000000000110100100001000000001001000
00000000110000010000010101011000000100011010000000000001000000100100000000110010001010000010000100000
10111000000001011000000010000010100100000000000001010000110000000000001010000000100000010011111100111
00000000001000001101000000011110010001010011011010010100001100010001000000110001000100000010001100000
01000010011110000000000100100101001100001100111000010000011011100001010001000000000101001001000000100
11000000010100000000000101001000000010100000010100000101000000100110000101000011000000010111001010110
00100111001101000000100100010010100000010000010001000001000001100010011001010010001000010010010000010
10000100100000000100010011100000000100000000101011000100101000001100100010011000100110000000000000011
00000001100010001000000110000010000100110010000110000101000000100010000000010000100010000000101110101
00100001001000000001011111001001111100011000110011000010010110011100100101010110010100000000010100000
10000011010100001010100000100010101011000101111001001011000000000101100000000100010000001001000100101
11001001101011010000100000010000000000000100000011011000101010000010001001000101000001000000111010010
00000010000001010000010011000001100100000000101010001001101000100111001001000100101000010010001010001
01111010110000100001111000100000101100111001111001010010110011111000010100110000101000001000000010001
01010110000001000001100110010101000000000000001000000010000010000100110100000001111011110001101000001
00010011100100000000100111010110000100100000010100010100001110000100010001000001110000001101100000001
00000111000001000000001100000001000101010000100000000000001100000001010100011000010010000010000001101
00010010010000010001000101010100000100100000001100011100001010000000010110000000110100001000111000000
00001011000001111010011001010100000100001000100000010000011011010010000010110000001010110000000111101
00001010001001101110000010000110101010011100100010000100000111110000001110001100101101000001000100000
10101000111000000000000011101000100010101000000001010000001110001100010001010110000010001000000110001
00010010000000101100100110100000000001000000000000000000010011000101111111010010001001110100000100010
00010010000100100010010100001000100001000001010100001110000000000000010011001000100000100100110011000
01010000101010000101000111100000110110100000100000101100011000100001110000100100010010011100100101001
00100100010111010001110000101000001000110011000000000000001000100101000000101100000000011010000000000
10110100100101001010100000110011000001100001110110011010100000000000000000010000001001000000100000011
00000100000000101001100000000000011000010010000010001001000011010100000000101000000000000111110100100
10010010010000000100100011000001000000001010011000101001000000100000010000100100000010011000011000110
00010000000000101010001100000100100000001011100000010110000101110100101000101010110100010110000100001
00100100100010001000000011001100010110000111101001011001100000100010001000100100000011100000001010010
00000001000010110000000010000000000000011000000001010001000000001101000001001000000010001010100110010
10000000001000001110011100100101000000000010010100000000011000000010000001000011110000110000000000000
00000000011101101000101000010101000000010000001000100000000101001100000010000000100000000000000010100
11100010000000000000000011101000010001100000010000001010100000100001000101101000011010000010010101110
00010000100010100010010001110110010010000100001000100000101000001000100111100010001000001100000001011
