00101001000011010111101000010000000010001000000010011010001110001000000101110000000100000000001010100
00001010000000010001000000010000111000000001010010110111010101001010000001110001010010100110010010110
11001110000000000010100010000100001000000100000110000000000100001100110000000110001110111001001100110
00010011010000010110100000101000010001110000111000101000011001011001101000101000000100001110110100000
00010100000100001100011001010010100101010100011000011001100000001000011010010100110000100000000001000
10010001110000100101000010000100010011000001000100100010010000100100110001101000000100000000010100000
10011011100001010001000000001110000101000001011010010010001100011010001011000101000001000001010011001
10100011010100110001000010001001001000000101000011000000100000111010001011000100000010110001000010010
11000110010000000000100010111000001010000000001001010010111000100110000100000001010000001110100001101
10000010100110101100001001001110010000000100100000010011001000010110010000010001001000110100000000000
10001000010000000010111100000011001000010000000000010000001000010000000000000000100100101110110101000
00000000011000000010000010010001000001000010000010110001000010001000100000010000100010000100000110100
10000111000000000001000101100001000000110100010011000110001110010000000000100000100000001010100010000
00011110000001110011000000001000100100000000001000000101001101100100000000000100111000010101000100000
01100010000000001100010010001000000111100011000010001100010000100100001101000010100000001010001000000
10000100000101000000001101000111000001001010010000000001111000101000000011000001100000001000110001000
00000000010000010101000000010111010001100000100100000000000000010000000001010000010100001111001101001
01000010000001000000001000100000110100010110000010001011001100000000100110100011000011000000101011000
00010110111000000100110110011000100010100000010001010010001111010000010100110100100001110000010000001
11000000000000001000000000000101000011000000010110100110000000010010000000001010110011010000000000000
00010000000100101100000110001000100000000001000100100101000000000000000000010011000110000100000011010
01100110011001000101011100001011000000110101001100100001010110100010000001000100101000000000000000000
00000001100100000000010000010000001010100000010001000000100101001101000000000000000000011011100100010
00010000100010010000010000010110000000000000001010101010010000000000000100000001010100000000001000001
10000000001110011010000000101100010100001000000101010000000000011111000100100000100000101000001100010
10010000001101001110100111000001010110000011100111001011100100000100101110000010101011100010010011000
01110110100000100010010110100001010000001000010000001001000000001001001000011101000010000001000000000
00000000001001001100100010110000100100100001111110100000100000100010000001110100001000000000011100000
00000010101110011000000111011110001001000010001100100001000010001100011000101011010110110101011010011
11100000110000101000110110000110001011111000110000000001000100000100000000110010100100000111001011000
00010101010101101100000010011100000010000010100100000001001100000000010110000001000000110010010001101
00010000110100010000000000010010000110010001000000000001110110110100000010010100000010010011101001101
00001100000010111010000000001001000000000100001101001001011000000000000001100100000100001010000001000
10100110000000110001000000111001010000111001000000010000000000011000001010010000001110011010000001001
10000000011110000000000111010011010000000011000111001010100100000010111101100001001011100000110001000
01000001000010000001001100110100000010100001000000000100010000001101011101010001101111000000001110000
10101000100001000100100000110000010100100100000110000100001010000000010000000010000111001101001000000
00000001000010001110101001001000001000000010010000000111101000111000101000000010000000000001000010111
00000000000101100000110001000001001100000101100000000000100000110110000110101001101000100000000010000
10001000000010000100000000000010110000011101001110101000110001001100000001000010101100010001011000000
01010100000011010111110000101000000000010000100000000100001101000100000110001000100101100000010110101
01100000110010101000101001000010010000100100101000000010000000001010000110000000110011010010100001000
01100000000111100000010010000000010010101001001000000000000000000101001001000101001000001001111000100
00000000000000000000000000000000000000110001000000000110000000000000000100001010101001000001100011011
01001110011101100100010000010000010100011001000000111011000110011101000000011001011001000000000011101
11100000110100000101001010000110001000000101000001011101011000110101110100011000000111000000000010000
00100000010010000010000011101000010010000000100100001100100000000100001000010010001001100010100000000
11001000100000001010000010000000010010000111110010100000000000000001000110010110000000000000011000001
10010111001000001000000010000111011001100001000010000100101100010000001110000000001010100001000000011
01111010100100000000010100100011100010010101101000110000101001100000000000000001001000001000100101111
01000000000011100100000001010100101101000000001010001010000000000100101000000000010010010000000001100
00000000000001001100000101010000100000011010000010000100101100000010000010100000000001001001001010000
00000110000011100010010000000100000111011001000100000000110100000011000100000110010001000000000100101
10000110000001000001011000110010010010001001010101000100001100100010000000100110101000101100010000101
11001000000100001010000010110010000101010001000100010010000010010010000100010000010100000000100100100
11110100001011001001100101100000000100100100011011110011101000011111001000011010100000101000000000000
00011101110001000111011001000110000000101000010110100000000100000010110001000111000100010100110001001
00110010110001111000000001010100010000010100010000111000010110101011000010100011100000001001010110100
00100100100000000000011001000010001000000010000101010010010110010000000011000100000001000001010100010
00000101001010110000110100011000010100101000100001010100000100001010000101011000010001100100101000000
11110100010000000100000000000011100001011011000101010000001001111100010011000101000101100000001000000
01100000010001001100001100100000001101000000101000010000100010100111000110000110011001100011010000100
01000100110001000001000001010000010000100000000100110000100001100010100010001010100100100000000010010
10101001001000101100001100000101001000001000000100000000010100010000100100000010010101000000000111010
00001000101101101001001001101100001001010110010000001011010000000100000000000000110010000100011000000
00100101000110010010011000000010000101001010001001000010000000001000010011111101010000000100001001011
01101000100010010000000011100000110011100000010000001000000010100100000010000101011100000100001000000
00001011100101010010000101000010000000000111000000110010000010001010000000010001000000000000010010000
00100000000100000110110101110001010001010000000010001011001011000000001100011101000001010101010010100
00000010111100101001111010000111101100000001001101000000010000100101110000000110100000010000010110001
11000010001010100000010000000000001000001101001001100010110000010001001000110111100010000010010000100
11000100001101000010010000100100100000101100110110101000010000000001100000000100100000000100000001000
10101000010000010111100000100100000010110001010100001100000010010000000010000001010001000100100001110
01010000010111000000000010000110001000110100000000000010100101000000100001101000010000111001001000110
10010000001001000100001000000010000001001001000010000011000000010100110001000000000100000000000000000
01011101110110101010100101100001100001101010000000100000000000000101000100101011101010101000001100000
01010000000011001001000000010110000100000000010000110000100110110000001100000000010010001100000001000
01110000100111000000100010010001000001001010101000010001000000111001000110000000110100000110100000001
10000000000000000110001000101010101000011001010100001000100000100010000000001000000001100011100000110
01010000000010100100011011000000010001100000100110000100010000100100001000001100010000000100100100010
00000001010000110000000000000010001010111000011011100100000101000111001000100000001000100000100010000
00000110100000010010000000000000000001001010001100000100000000010000100100000110000000010000010001000
10001000000111010000000000000000001001110100001110011000000100100001011011001000001001000010001100000
00011000000000010000101000111101000000100010100000100000010000011101000011000000100011000000000001100
00010000001000010110111000010000010100000101000000000100000100010100000010000000000000010010100000000
00100010110011001000011001100000110000000010001010000011010100011000010100100100100000110110000001000
00010010000100011010010000010101000001101010100010011111011010100100100000111011000001000000010110100
01100110110000010001010110111101111000001010000100110110010100010010100001000001010100100010010000011
00001010000000101011010110010001100011000010101001011000000100000001001000110011000000000000001010000
01000001001100001010100010010010010100110010000100100100001001001010101100000011001001001101000001111
01100101001100000010000001001010100001001010000010010000100100000010010000100101100010011001000000000
10000110000100111110011110010000000010100100010001001100010110000000010000110000000000001000100100000
10100000101000100000000110011010101101011110100000100000001010000111001000100000100000011100101101000
01101000100000000000001010000010100100001001010101111000000101000000011001010000010010100000010000010
01000001101000000110000011000011000010011100101100000010010010110100100110010010100010000000100000000
01001100110000100100000000001010101110000111100000101000000000110001100100001001001100000101110100000
01000010000110001010010101000011001001000010001100000000000100110000100100011100001100110110000100000
01000101011100110100111010000010011010000000010000010110000001101000101010000001000000110100000000001
01001000001000001100010010101001000001001100001001000010100011010010100000000100110100000000101010100
00010000011000000100000010100111101101001001100100010111001000101100111100100000010010000000011010001
10101100000000001010010100010001011010001000001000001110000100010000000000011000001010010000000000100
