11000000000000110110011000010000000000000001001000000000010011000000110000010000010010000010010000000
00001000010000001110001100000000000010000010001000100001000001001011001000000101011011110111000110100
00011001110010000000100010001000001000111011000000111101000000001000100010001010100010000010000000001
11000000000011001001100000010011001010010000000000100100001000110000000110001000100001100100000000000
00000110010010100010001001000010000101011000101000000100010001000100010001001001100100000000000000010
01000110100100000000000000000000100001000001000100001011000001000111100001001010001100000100100100010
00001110000010000110000000000010100100000111101010111001100000001110000100101001000000000001000000000
00000010000000100000101001110110001111110010101001111000100000111000010010000010001011010011001011010
10101100001110011000000011101000000010000000000000110000000111011001101000100000001000000000000101000
00101110000101100011100001010100100100000000100100100000101000010010000001010010010010001001010000110
00010101000000101011100000101000000001100100110000100011100111100000011010010010111000011010000110010
00000000010010001101000011011010100010000001010111100100110101000001010000000100100010010000000101001
00100101011000000000010000000000000100011010000010001101101010010010100000001000100001011110000000000
10010000001000101000100001000100000011111000000111000111000000010000100000010100001000001100100110100
00000101000011011000000001100011000011001010010000010010110000111000101000001011100100000000010000010
10001001010100000000100011010101001000100101100000000100010000111000001010100100000100001100000000000
00000010000110000001101001011100000001011000000101000100001001110000000101000000110000100000100000011
00001100001010000000110110000001100110010011101010000000000101000100000101100011000000100010000000010
11011011010011001001001101011000001011101010001000011000000000101101110110010001000000100011101000110
00001100010001111000000011010010011001001100001001110010000010100010011001000011001010001101000101000
01000100000000100000010001010101110110010001001010100010101010010100010001000001001100100101010000010
01000110100000110110000001100011100010000000010010010010001001111001110100000011000011001001000000000
10001110100000000010000000100101001000000001011100001100011001000010000001011000010010011000001000001
00010101010001010001100000110000101100100011110100010100000111100101010100000000001101010010100010110
00011001100001000110001100101110110001000010000000000000010010000001100110000000001100101001000100100
10011010000000000001000000000100101011111001000000000111000001110001000010111100010000100110000001000
10000001010000000101001001010100010000000100101000001010101101000010100000010001000000100100000000111
00100100000000100111100010110001001000000000000101000100101111100001010100000100001110001010011000000
00110010010001001000000000110010001010001010001101011000110011000000011000010000000000100010000000100
00011100000100110000100001001000010001001010000010000101001000000000110100000001000100000010011000000
01010001001010000111100010000001000100010101100001110000000010000000001100100011000110011100100101110
10100010111001000000100100111101111011001010101111001000010001000110001010010101010000000101011010010
00000010010101101110110111000000000000111001000000000000001000110000000101011010001101111000100001000
00010001011000100001011000110000110000000000011000010001110100100001100111000000011000000110000000000
10010010101000100111101110111111110000111010100000101010000000001010000100000100000000001111000001101
01010101100001000000000000100001101000101111000000111001000101101000100110000110000000000000100000001
01000000100000010110100000000000000000010010100001000000000000010000100001011001000010101100000100000
10011000111110101010100010101110100010000010001000000000001010001011000010001100010101000000011010001
00100011000000100001001000100001110101000000000010100001010100101011100001010101010100101000000000000
00111110101000011001000100010110000010100010100000000010100000000000000001000011100010010011011000010
01110100111000001000100011000000101100100011000010000100000111000110000011010001000000110000000000001
01001000001100110000000110010000001000011011000101100100000110000001011000001010011100111000001000000
10100100010010000000010011000011010011011001000001010100100101010000011101011000000000001100111000000
00001010100100110000000100000100010000000001100101110010100000110001010100100001010000101000000001000
10001010000010000100101110001000000000000110001011000011101010100001100010010000001101101010000000110
00000010000000100101001001100100101111000001100000010000101010001010010000100000010000101000000001011
11100100001100010000010001101000010001010010000011001000010001000001001010001010011011100000100000000
01000011100000101000000101011000000100100010001101000001000100100100100001000000001001100010010000010
10101100001101110000101000000000010110000011000100001000010001010000100010110001100001101101000010000
00000110100001010011000000110111010110101100101010000100010000010000011100010001001111011111000111100
00011001010010000010000010101100000000010010010000011000110000000000001100010010001101000110111010100
00000000000100100000100101000000101010010000011000001010011100001101000110010100110011001011000000101
10010100011001101010100000010000010110000001001000000011000011010000000000001001010010100000001000000
00001100010000000011001100100100000010001000100010000000010010100000011100000001010000000000001000000
00010000100100100101101110000000100000100011101101000001001000001001100000100000100000000000010000010
00100100010010001100001001001111111010100000000100010101101000111100001000001010100010010001011000011
00000000001000101000010000010000000001101000000001000000000111011000100010000001101000101100010010101
00000110000000000000010001010001100010100100101110111100000011100100000010111001000000100110110000100
00010000000001000110111100000100100111100110101100101000010100011101100011001000000010010001001100000
01101000000100001000010000010000101001100010000001000100010000101001010000001100010010001000010011011
00000100100100010000010100100000101000100111110010101001100110100010100010101000010001100010100001011
00100011001000110100011010000010101001111010001000011000000001001010001101101100000000111000000100001
01010100001110001110001100010000010010010000110000100111000100000100010000000000100001101100000011001
01001000111011010001000000010001010000100011010100000100010000000000000010110001111010000000100010010
10101011100001110110000010000101000101000011010101100000110000010000110111010000010110100100010000001
10001100011100000000000000000011000100001110000001011000111010001001000011101101101101100010000001001
00011100001000000000000000010101000000001100000010000110000000100000011010010001010001110000000000001
10000010011111010011000100110000100100000000101110000000000000000001010001000011101101101011011110001
00010000011001001101100010000001000011001100000010001100010010000100000010100000000001001101001110100
01000011001000010000000011101001000001010000101000000000100000011100001111011001010110111010100010000
00100100010001010100000000001001000010001001000000001000000101010100010010000001110010010100101000000
11000000110100001110010110100100000001000101100000000010100100001101000000010001100010000100100110111
00110000000000001000100000001010000100100000010000000000000110000100001000000000000011100100101001000
00001000000000001001110000000010000100000100100000000001000010100000001000010000011000010010001010101
00010000001101100000101000010100000001100101001110110000000100000100010010100000000010000000001011011
00000000110010100100101101000010100001101010000011000010100100000001100000000101000000000011000010001
11110000110101000000000001010111100100001101000100011010010100100000110000010010000101101010011100000
00000010000111100000101000000000000100011000110010000001100000000010000010000001010010100000001010101
01000000000001000100000000011000000100010000001001011100001000001000011000000000110000011100100010100
00110010010010001000111010101001001001100110001000001000000001000010010100010101100000111010100010000
00000110010000100010001001011110000111010000010000000010000000010001011001000001000000000101100011100
10100011000000001001000110000101111010000100100010000000000110010100000110000000000000101011000101010
10100001000010010000100000101101000110000110011010111010000011100111111000000000000011010100101100000
00001110010101101100100000001000101101000110000101000000000100000000110101111000100101000000000001110
00001101110000100000000001000100100000100000010011110000000110111000000000001010011000000000000011000
01000000100000100010011000000110001110000010100001000100000100101110000101100000100000110001010001000
00100001010100000000101000000001010110000001100100010010000010000000000101000100011010000101100001000
00100110100001010100011101001100001010000000010100011000101001001100000000101011010010000110100001011
11000001011001100000010010001111000000101111000011001000101000000000001000000000100000001100010001010
00010000100100010000000001100001001000011100010100100000010000000010101000000001011100010110100010100
11101010010000000111101101000100010001100000101000001100100100010100101111101110010110100000011011000
01000100110100101001010101000001100000011111000000000001001110011000110001101000100000000101110000001
00011001111000000000100010000101001110010110100000010010010100100110011101000110000000000111010010000
01001011000000001111001001011000010000010000000100001000011110101010100101000010001000010001001010000
10101000100100000100000000010100000101101011010001000010001100000000010000101001010101000000010001000
10000111010001000100001101110011001001000100000000000010110101110000100001010000000010101010010000001
00001010000010100100100010000000001010001010000100000001100000101000001000000110000000101010100000000
00001011011110101001100000010100101000010110100100001000100001101010100100001000011000100011000000011
00000100000100000101000000010011001000111000100000010100000111100000010000000010001110111000100110010
00101000000100000010001011000101000000111000010000010001011011000010011000010000100000001000111100001
11000011100000001010000011000101000001000010110001001110010000001000001111000000000010001110001100010
