01001100010010100000110001100001000000101010001000100000010000000000001001110000011100001000100010000
00101000100010010000011010000100011011000100001000101100010011000100011001111100000010001000000000001
11001101000010011000000001110101100000011001010000010101011010000001000000100110000000101100101100000
10000110010000100010000100101000011100000010001110110011000001100010001100100000010000100100001011011
01000001000010000110000000010001001001001000000000010001100011000010101000110001010101111110000010100
00100000000001001000100010000010000000000010110011101001010001110000000001000000001000011010110010010
00000100100000100001010111111000000000010000001001101101100010000110011010110101110001000000111010001
10001101100000000000110001000100001000110100000100100110000000100000000001000000000110000110010000100
00101000110110001000100000100000001000010100010000100010110000101111100000010000000010000100110111101
00000000010000011110001010010000000100000000111100000001111000000000011101001011001010010000100010100
00000011010111100100000111100000000100011000000010110000000000100010000001000000001100000010000111100
10000000011000000100000100000000000010000010000110001100010100000000000000001100000000100000010010111
00010011001010000010010000000110110011110010001100010100000000010010000001110000001011100000000001000
11001001100111010010010000001100000100000011110001100000101000001110010000000000100010000100100100110
01000101101010110101100110000000001010011110000100101010001010001010010110000100001101000000100000100
00000000010101000000100001000100011001110100000000010010000000000001011000110000101110111000000011000
10000100100000110110100100100001000000001001111001100010001000001000000001000100001100000000000001000
01000001000001000011100000000011010010000001000011001110101011000101100010100000101010010000000000100
11000000011011011000100001001100001010100100000000000000000010000000010000000000011001000000100010100
00001100010100010101000000000000110000011001111000010001010010000001101101000000000000010010000000001
00001000001101000000101000000100000000100001001000000000110000001100000100100000011011101000000011000
00000001000000010010000110000010000000100000000000011000000000000101000001000001100001010111010100000
00010001101001011010000000000110010000100010100000000001010000000100110100000000001000000000000000100
00000111001000000110000000000110101010100100100000000110010000000010101010000101000101010010001100010
11101000000100001110000000010000000000000000100000100011011000000000100100000110010000001100000100001
10000101001011101101011001000000101101000000100000000001000001001001101110110000100000010011110010101
00000110000000000011100000100000000000011000101000100010001011100110010100011000000010110000010010001
00000010011001100010001111100000101000011000111101010100001010101101110011101100010000101100000011001
00001010101001100100000000001000001010001000011010110100111100001001001110101010001011011010100011100
00000001100111001000011000100011001000100000010000000001000100111001000100001110101000001001001100000
01101010010010000100000000010000100110100110001100100000101001100100010001000010001001000100001001000
10001001000000010101000101010000110000100000001001001000110101000001000000000110001001011000010100001
00000101010000100100000110100100110010001010100000100100000000000000000010111000001100100000110101000
00100100110011010000000001001000000100000111000000001110010000001010000000000001100001010100001000011
00100111100011001000001000010010000000001000001000001010100001000011010100000001010000000011101000100
11010000000100000001010010000001000100001000110010101000000100011000000101000000000000001001011001001
01000010000001100000011000001000010001100000011011000100010000000000000010010010100010010111001010001
10010011000010111001000001000011101110001100000001001001001000001001000100010100100010100001010010100
10000001111100110000101001101000000001000000010001000000000100000000010010000110111001000100000100010
00101000100000000001011010100000000111100010010100001011010000100010000100010100001100100000110110001
00010010101001010011000000010000100000100111001000001000100010101001010001110111001101000101111000000
00001000000100000001000001010100100000100000000101110001001100000000000000000000000001101000000000010
01000000011000000010010100000000100011000000101000000100100000010001001111010000100110111000010010110
00010001000000000100000000000110000000000000000010100010111101000000010000001000010000111000010110000
01000010011010001000000100000100000100110000100001000100011010010000111000100000000001001000000010010
00000000000001000110000010100001000001110010000000000000100101000110001100010101001010010000100011010
01000000000001000100001101100000100001010100100001000000000110000000100000101000000100010000010010000
11100101000000101000011101000100000000100100000000000110001000010001100001110011110100000000010001001
00110010111111010100000100000000010110000010000001101000001000100010000000100001000101101000010100110
01111000000000011000000001100111001110000000000001100100000100010100000010000010010000110100000100010
00100000111110000010001001001000010010111011001000000100000010000010001001000110000100001000100100000
01010001111101000100111010000000010100000000000000010101010000001101010010000111000010110100000010000
00000001000000010000000000011100000010000100001000000001000101100000000100010100010001111000011010000
00000001000010000001000010100000101001000000010000000000010001011010010101011001001001001000000100010
10000101000001001011000111101001010110010000100101000011001011000100000001000000000010001001010000000
00000000000001001100000001001101000100100000100101101100100000001100011000111010111000010001011001100
11000000001001001010111001000101000100000010010001000010110000100000011000100001000000000000010000000
01100001100010000000010010100000001010010101000010000000000100000100100010001110000010000001000100011
00100001010001000100100100000010010001000101000000001000011100101000101000010010000000100010000001000
10000000000100101001001100101111011010000010001000100000001001000000100000000000010000000101110101010
01001000001110101100000011000010011010000000000001001000110100110101010101100001110110010010000001000
00100000001000001001000000100000000010001110010101110000000001011000000000000010001000100100101100110
00000000000111100100000000000100101011000001011100000010100000100100110100000000000010011000000000001
00000010100110000101110001000000000000010010010000010010101001001000010011111000000001100001100110000
01110101000001110010100010100001000100000010010001000000000001011000101001000010000011100001000110000
10000001001010000001101001100000101110010010100000001010010000000100001000001010001010101011000011100
11101010100000000000000101000011011100010000000000110000000000000011100010100100100100010100101110100
00000000000001010001100010001001011000100101000000100000110010110100000100100001000100001001000100000
00000110000010000000001000001100001111001100010110001001001010001001101000000000011010000010000111000
00000000000000001100100000110111110000100010000000101000000000100000000000000100011101011001100000100
00100100110000110010101000000100000110010011010010001001100100100011000100100000100001000001000100010
00011010101110000010100010100101001000001111001011000000000000001010001001111011000000100000110000000
00101000000001001010000111000000000000001010000110000100000010000111000010010100101000101001010101000
00000011010001001100001000110101001000010001100011001110000000001000010010001000001001010110000100110
00000101100010010000000100010001011000000111000000010100100001011110000000100110101011000001000000111
00010000000001010100000000100100010001001111011000001100000011100101100101100101001100000010010000000
01110010000100100100100010000001100000101110001001000100001010100100010100000000100000100000010010011
00101010001101000010000000010100001000110000010000111100111000110000000001000000001001001010100100010
00100101000000000001001001111001000000010011110000000011000110000000000000000110001001000010000000001
00000000000000100001010000000011000001010000101000000010001010100010000100000100001001100110001100010
01000000101010000001000001000101000000000000001010000001010010100000100110000000111010000001001010000
01110001010010000001001010100000101000010100000000001000100011010001000000110000101000100000000000011
11000100000100011000000100000000100000000000100000000010101011000000001000000100110100000000010100100
00010000010100111000010000110010001010000100001001010010000100000000010000010000010110110001010010000
00100001010110001010010100100100001011010000000010001010000000000000001100011000000110010000000000100
10011100001100000000001010000100101000000000110100001100100111100000000100010001000000110010010000000
10000101000100010010011010000011000110000000100110101000111000100010000010100010100010100011100000000
00100000000000101000000001010000110001110000110110010010100100000010001100000001100001000010000000100
00001001000010001100000100001110001010000100010001001100110000001000001100010100000011010000101000011
00001011100010010100010001000001000010000110100001000010001000010000100000100001001010001001100000000
10000000000100000100101010010000000011000000100011100110001000010001000000010000000010000000001011100
00011000101011000010110100001000011100010011101001011010010000000100000001000010000100110001000000111
01010000100011000001000001001001110001000001001001011011100110100001000110111001000111000000001001000
11000000100001000011111000000000101000110010100000010010100001100010010000100001000110100100110011100
00000000110010001001100100000110000000101001000000001101001001010000000000111000110110010001001010000
00100101010000000000000000000100101010000000010000011101010000101000101000000100001000010000100000110
10010000000100101011000101000101000001000111000000100101001111000001100010100000011000100000000001000
10011010000000000000000000000100011010000001010111010000001000001010000100001010000010000000000100001
10101010010010101010011001000100011000101001000000110100001111000000000000000001000001000010110010000
00000000001001000001000010110001010010000000110011001000000000001011010001100111000010100011010010100
00001001001100000000000111110010000100100001110000000000001010000100110100010000000001000100010010110
