01000000010010000010000000001001001010100001000000001000110111001001010000000001011000111000101011101
10000000000010100000101010101100000011000000000100110000000001001011100000000000011001001010100100001
00010000101000000001000000011100010100010000000100001100111011010001011011100001010010100110001000101
10000000000010010001010000110100100000100001010101010000111100000100010001000101000001010011011000001
10000001000001010111100100000001000110100001010100001001000000000110101100000000111000100000011101000
10000010001000100001000000000100000000001010101001110000100101000000000110110001000001110100000001001
00000000001001010001000000010000000011001000000001011000000000001011000000001001010000010001010000111
00101010100011101000010100010010000101110000101000000101001110000100100001010001001000100000101000110
00000000000000000000000100000000000010000000010110110000100000001000100001100001000010100001001000000
01011010000000010100001010000000001010100000110010010000100000101101001000000101000000011110001010011
11000000001000011000000000001001000100000000101110001000000101110000010100000010010110011010101100000
00001100100011100011010010010000010001000011100001110010101010100000011000000111000000100011110000110
11010100110100001100110001010111111100000110000000010110010011010010001000000000010011010000011000110
01000110000010000010010101000000000000010011000000010010000000001000000010000010001000000001101101010
00000111100010000010000011000000101010000000110000001000010101110000110100100000000101110000010000000
10001110011001110100011100100011110000000011000011011000000010000000011100000000010111000011010001000
00000010010000010000100100001010001001000100101010100100010001100000010001000011010000111000000000000
01100001110001000000011011010010000000100011000000000001110000010010010001100100010000001010000100110
00000101001100010111011000000000100000100110101100000000100100000000000100100010010010100100111001010
01100100100011001100000110100001101001000000100000000100000001000000000011000001001001110000000010000
10100001000000011000000100100000000100010010000001000111001010001001100010000100000100101011000100010
00111101100001000000101100010000011000000101000000000111011110011010001010001000011000001000100100010
10100000010000000000000000000010010001010110010100000100000000000100110010000010100101101011000100011
10000000100001000001100000010000000000011001010100001001000100100101000100100100000111000001000000001
00000000001010000100100000001001101000000001000001100000100011000010110100111101100000000000000010110
00110000010001100111000000000000101000001011001000010100101000001011110110000010000001000000000100010
11110000011110000100100110001000000110010100010000000110010001100111010100001110101110100000010101000
10101000001000000000110010100011000001100000010000000000000011000000110100101010000110000011000010101
00011101000101000100000100110000010010010001000100001001100000100110100000100010011000010101000000111
10010100000000000100010011001000010100010100001010011001101000000000001001100101000010000000000100000
00100000010100001100010110100000100000010011000000000000001110100001100000001010011000001000000100000
00001001010000000010100101011010000100010000110010000100000000100110001010100001010000010001101011000
01100000100001010001010000100000111011000000010010000001001110010000001100000000010001000000101000001
00000000110000110110000001000100100100010100110110110010001000100000100000010000000101011000001100000
00000010010000010001010100010000100111100010000100000001011000100000010000100010011101000010110000001
00010001000111000001000010011001001000001000000100101100000000010000010100101101101000001111010110001
01001001001001010011100001011000001000100101010000010001010101010110001001000011000100000010001010010
00011101010001000001111000001000101011100100100000011110000000110000000011000000000000000101000011110
00001111000000000001000110001100000001101001000010010110100101010000010000001000000000101110000110000
01010010011000101100101011000001011100010000100001001101001000100000000001100100101011000011100001100
00000111000101000000000000000000011100010101000100011101100100000011010000001000100100010111101000000
00011000101000001000000010000010010000010000010000001000010000100001000000001001100100000000010100100
10001000110000000000110000000000010000001001010100010011001000000111101000011001101011110000000000001
00001111000110000001001111001000101011000001001000000010100001101011000001000001110101000101000000101
10111000010101000000000000010101100000010011001010000000001001000110110000000010110110001100000100101
00001000110001101000001000100000010000011110111001111000001100001101101001000000001000001000101101001
10010010100010001000011011000101000010100100000010100110000000110010000101010000000010000101010100010
00001100100010000001001001110000010110000000000000000001010111011100001000111011001010001001001000100
00100000000000011000101010001000010100100111100001010000010000000000110000001010000111000110000100001
00100111100000101011100111000100100000010000101111101000101110001110000101110001101100010101001000010
00100001110010000100010101110111000100010011100001000000000000000000110001000010000100000000001000000
01100100000010010000100010010000010100001100011000000010110000110000101000001011001001010100000110001
00000000110000010000011010000100000000111100100001000001000010000000000010000000000010101110000101000
01100000010001100000101000100010111110001000001100010010001000000010100000000101011000001000100100000
01111010001000000100101001000000000000100000000000100000100010001000101100010000011000010010001000000
10100000000000000000000000100001000100100011100100100010010011101110101010011001011000010000000011010
00100100000010100000010010100110000000000000011010000011001110010100011000110011000001100001100100100
10010010100000000000011011000000000001000000010000000100011101000010000000001010011100111011011100000
11000010001000100100111000110000110101010100001001101010000011011010101001110010100010000000101000000
00110111011001100110100000000110110010101000010000000000000000000000000110100010000000000100000101001
11111111000000000010110010000101010000000000110011001110001000100000001000001010011000101000010010000
00000010010000100000100011000010000000010000010101000010001000000010000010101000010010001010100010111
01000100010100000110111101000010010001000101010000101000110000010001100101100010001000001000000001010
01100100000101001010001110001000000101010010000000000100010000000000101000001001010110111000000000111
00101000111000100001000000111101000100000000000110100000101100000001101010000011000000110100000010101
00110010011111111110000001100101000000001111000110001100010011000000100000110001011000000111001101100
00100100010000010010000100000110011100000010001010010001000010000111000000010000000000100001100100000
10001000000001101010010000000000010000010100000101000001000100001100101001001000101000000100001000011
00000010100100010001011100001010010001000000101111000010001000000000000010011000000000000010010010110
10101000001000100100010110000000010010011100110111010111001001101010101000000000010000100010001000000
00100100000110001100011100000101001011010100001000101000111000000100011010001000010101000000011000000
00010110000101110000000000001010011011100010100010110010111011110100001000001010001000010000000100100
00100001000010010000001010000001100000011110100000001000001100111000010011010000000111100100110100010
00000011010010101101100100111001100000010100000001001100000000100000101000100000000000000001000001000
00000011010000110101000000000001100100101100011000100000000000000001000101100000001001100101001010000
10100000100000001010001101001100001001000010000100001001101010001100000000100000000000000011010101000
00000010011110000000000101010010000000110100001010000101010000101011111000010100001100000100011000100
00011000010110001100110100000000100000010010010001100000010101001001100110011001000111001000000011000
00000000010000101010000001010011000111000000001000010001111010100101000010001000010000011001010000000
10010010000100000101100000110001001010010000010000001000100001100001000100001000010010001100000110011
00010000001000010001000100000001010001110100000111110000011010101110011001001010000010001010100000101
00100000011000011000000000100001010000110010000001000000000000000000001000000010011000010000101001101
00000100000000001010011000000000000000000110000100000000100001000101100010000010010110100100010001000
11010001000101111100001000100101010001001001101001001001111101000000000000001000010101010101110001001
01100000100001000111100001010010101010110010001000000100000000000000100000011110001111000000000111001
00000000000011000000010101000001101100011110010000000100000100001000000110010110110100111000100100000
01110000001001000100011001011000010110000000000000000011001000000100100101000000000000000110000000001
00000011001000101000010110010010010101001011110001000110000001001101110001100000000110001110101010011
10000011100001101001000000010000010011000000000000101001010000000100010010010010100000010001000010011
11000011010010100000100000010000000000101000111000010010001111101000000000000100011100111100010101100
01000000100000010011000100101010000000000100010011010000101001010000001101000010000001001011100000111
01000000001101010110000101011011001001011100000000001000010100000000100000000100000100000000010001000
00000011010100000100111110010100000001101110011100000101000100010000000111000000000001000010001100000
11100000000010000011111010000001001000001001001100100000000001010000011000110011001000001000000010000
01000101001001101010010100010000110010001110100000010100001100000000100100000010000101000010100010000
01100100000000111000000000110000100110000000011110000010100001110111000101010001100000001001001101000
01000100110000011101000111000100010010110000011000000011010010000000000001000001100100100000110001101
00001100101110001110100000100000001001000011100100010011000010010000010011100001000100000001011011000
00000010110111110001010001011000100100000010010010000000001101000110000010110000000001011000100101100
00001000100000010100001000110000100101110000000100000000111000000010000010010001100000001001010010000
01010000100010110000000010100011010000000001001110100000001000000001000110101000001001000010111001000
