00101000110000000000010100110001011010001000000101001000101010000010000000010100000010001111011100001
00000110010100000110010100010101010000100101011100010000001001001010001000010111000101000110010000010
11100100010101001101010000011000010010001000100100000101001000010001100001000000100000001010000000100
10100001000001001000000000000000000011000010010001100001000000001000000010100000000000000001110001000
01001011001100000000100100011001101110111000100011101001000100010100101100000100000000110011000101000
10000000100100001100000101111010101010010100001111111000100011010111000010000000010001110110000110100
10001000100100111000000011101101110111000101100100000100000000110100011000000100001010001000100010100
10010010001010001000010001101011000001100111000011100110100010001010000000100100010011000001100001110
00100101110000001010000001100111000000010010101001000000001011011100001011110000000000000000100110000
10100010000000010011000000010101100000010001010000000110010001001001011011000001000111001110010001100
11010101010011101001101000001010000000110001000001100000001000011000001111001111001000001001000000010
00000100010001000100010010000000101111000111100100010001000000011000100000101010000001010000010100110
10000001111000000100011000100000101110100001010100001000001100010001011001011101000010111110000100000
00100010000100100000001100000001000000110010010101010011101001000010000010010010000011010001000010001
00101010000001000001010000000101000100100011101100101000100100100000011001101000101110000100000110010
00001000101000100000000100000100000010000000010011000000010011000000000011000010111000010110101010000
00000000001010010000100001101110001001000000000001100001000001000000010010010000000000110111000010000
01000010011110010010001110111010110100000001101000010001011010001001000000001100100010110001000110111
01000001110100001011101101100100000010000111000010100000101001000100011100100011000001000000010000001
00010110010010100010111101100110100010000010000011000000100100000100000010000000000011000000001011010
00000010010011000001000100010101010100000001110101010000001010000000100001000000100011000000001110101
00000110110000001110001011100011000100000010001011010000010010000000100100110001001100001011000101000
11000100010000111001110001010101011010000000000010110010000001000010110000011010100101100000011010011
00000100010100100010000110000000000101000000010000110000101011001001111110100001010011100010001111000
00001001110111001000111001100000110011110000010101000000000010000010111010100010000000000100010100000
10110000111011011000001101110000001010010100000100010100000100011001000000010110101010011001100000010
10010001000001100001000000000010000010000101011110100000000000011001000001010000011011010000000101000
10010001101001101100110111101111001011010101011010010001011110010000010100011100010100100000000001100
01110101000100100011001000101010001000000101000100010000010000000000001000000100010100011000101000000
10000001010100011101110010000101100000111000100101000000000001000000100011000110000010000001100100000
01001000000000110010010000010001000001100101101000100101010000100111000100010000000001100000011000001
00010001000001100111000000101001100000000000011010000000000010100001000100000100010000101000110100001
00010001000100011011111100001011001000010100010001000101110000000010001011110011000101100010110000000
01101100000000001100000000001000000010000100001100110000001000001000000010101110111010000100000001100
01000100001010100000001100000110001000100100000010101011001000000001000000100000000011101000000100100
10001000000101000100110010110100111000101101100000010010001000000101110110110010000001000001000011110
00001010011110100000001000100001000000011000101010110000100000110010010010000011100111011100001010001
00011010011001000000000000100010100000000000010000000110100000111000000000010000001000001000010000010
01000010101001010000000001011000010010001001111000011000111001000001000110110000010010110010000101100
01000010010100001101001000010000000000011001100000111100100100101000100100000000010011000000100100000
10011110001100110010101001001001101100001011000101010000011010000000010000101000000010100010000011011
00100000000001110001001000001011110101001100110000010000100000010111100001001000000000011000000001000
01000110010110101000010010010101000011110000011010000100000000010000111001010010000000010110000111000
01001000001010000000011110001000000001000001001010011000000110001001011000000110111000000010000011011
01000011000100011111010010100111000000110001000101000100100000100100000010000100100001010100111100000
00001001000101101100010011000110001000111100010010110101000100000010100010100000000011000000101011101
00010101010100000000000110010000001000000110011000001000010101000011101001100000000100000000110000000
00110100110000010100110010011001001100000100000100000000110001110000010000000000000101001000110001010
10110010000000000100000000110001001001100000010000100000100001001000000010010010000100000001000111100
01100001000000101001010001000000001000011000010101000110010100001000000000000000100000011101010011111
00100000011110000000000000001100101011100101011000010101010001010100001100001010100100001100000011001
10000100000000110110011000000001101000001010010000011010010001000001110001010010010100101101100100001
00100000000100001001010010001100110000100001100011010001101010000100000000101010000001001001001011100
00000000110001010000100101001000001011001110000010001000000001000111110000100101101010000100111100100
01010000010010010001001000001000010010000000110000000001101010001001000000100101100000000000101000000
00010010100110100101000010000010001100010000010010000100001000000000000001101100000000111000011101000
10101001001111010000000001010110011010110000010001010000100000100100000010111010000011000000001010000
00000011101010000101001101110101001000000010001001111000010000100010001000110100010100110000000010000
01000000100000001111110111000100101010111010110010000100110000011110100000000011000000001111110001010
11000010100000010100001010011000010010000011000110100101101100000100010000100000010100001000000110001
00000010100000110110001000001011000110011010000001011010001000101001110100000000001000010011101111100
00100100101001111000010010010100010100100000101000001000001000110100010101000000011110011000000000000
01001000011011000000100011001000110001000111000001001011110100000001001000100000001000000000000010010
01010010101100110100010000110111111000000010000100000010010000000101011100100100111010000011000000101
10001000100000101010000010001001000110001011001100011110000110011000110001111001000000010000010000001
10101100011001100001101110100000100001001000101000101001110010000000110111010000010011110000100010000
00001100101111010010001000011111000101101100010000010100100000011001000000000010111100110100010000000
10101011000110010001000100000000000010011000110000010001000100000100110010011010000001010100000011100
00001000000101000000010011110100010010100000000110001010100000001101000100001000100010010001110010010
10010000000011001100000000101100010001000010001001000000010110000000000010100101011110101000101000100
01010001100010000000101010000010000010001000000011001101001101011001000000011110000101100000100100001
00100011000111100100000000001000001010110010000010101001000010100100011000000101010100100001010101001
01000100000010000110001000000100101111001000001010000001000001100000011000011000100010000100000100011
01000101010110001000110011100000000000110000000000000010110110001101110000101100000000010001000000000
00101000100110010111101000010000000001000000110000000000100000010001100001011100000100001100110110011
10001000000010001010000001000001001001000001100000101110011000000001010000101000101100100100001000000
00000010010000000000001001100001000000000110001010001000110110000010100000100010000110101011000000010
00111100001001000100000010110110000100000010000001000100101000011101001100001000010100100110001011011
00001001000100000100110001110001000100000101100000010000011010111001000000110001000011000010110100000
10110110110010100010001000100101001100100000000100000001000100000101000000010000001000111101000000010
00010000000010101000010001000001000000110001000000000001000100100000010000000000011000010100000000100
00000110000001010010000101000011010001100101100000000100000100101111011010010001000001000101011001011
00001010000100010011100001110000110000001010110000010001001100100001000110001011100000001001010101001
01011000001100100000001000100010000000010000001101000001001000000000110010000000101000000000000000100
11100101000000100001000001010100000001000000000100010010011100001001110010000000101001011001100010000
00001100100000100000000000000101000100000000001000001001000010000001000001000001100101010100111000000
00110010000110011000010000011000010010011110100001100100010010000011110100000110000000110100110000110
00000100110100100000000100110100001110100100001001010110001100000000011000010000001000000100001010010
00100110101000110100100101011111001010000000011001000010100110000001001000100001001010100111111000000
00001000000101001010010000110011011000000101000000001100000010011000000001000101011100100011100010010
00001010100100100000001100000000011100010101000000010010100000001000100000001011111011101100000010011
00001011011000001000000100101010100010010100000000000110000000000001001010010000000101111000110000101
00000010001001110001010000001010011001000100001000110000011001100011001000000100001100110100010001010
10000000001010000100000011001000000001000010000001111001101001100000001110000100100000001000000001101
11101000010000101011001000010011000110110100000000001100000001101100001000001011001000001011101011001
10000110000000010011100001001010100101001000000100000000100000010000000000010001000000011000111000000
10001000101011000001000000100000001100000010000001000101000001100000000100000000101000001000011010100
00000100001100110100010010110001000011000111000010101011000000110001010011001010000100101010001010000
00010100100010000100110001010000000000000100100000101000001000010000000001001100100101000000100111000
10111000000000000000000001001100000001000001010010000011000000000010001100010000001101100000000000111
01010110100000000000001110000101011111001000100000000010000001110100000100000011110110001000000000000
