10000010101111000000001010000000001000100100000101001010101101001000010000110011100010100000000100011
00000001001000000000011000010000010000000010100010000001000000000010010110100000010100000011000000001
01101000100000000000110101100010100010101000110000101100011000100100010100011111010001110110100001000
00001001001011100001000111000101010010000100000000001110001011000100000100000001011011000000001011010
00001000000001000001010000001010100101101110011011000000000001100010001111010100011011000010011000101
01011010000000000101001010011000001000100000100010000000001001010010110101000000000011100010000100101
01000001001111011000100010010010011001110100010010110000101000110011111000010100000000000110100101011
00011000100001100010000110110001001011010000000101010000001100001011000000000100000010000000000010101
10000100110000110000000100000110100000010001110010100001000100100010001110001000011000101000001011001
01000010001000001000101011011001000001101011000011001000000001001100100000010010110011111010110011001
00000000001011010100111010000000001011100010000100010010001011001001100011111000000100011010000100100
10000000000011000000101100001101010010000001000000000010000110010001000000000000010001100010010011100
11011001100101000000101010100101100001001001010011001011000001000010000100000100111001000100110110000
10010000000000001000010010111000010000010000001100101101100001001000000000000011000100001100000000010
00100010011000101010101010001001000101111010010010010000100001010000000011100100000000101000000010010
00101101010010100100000101101101000101110010100111100000100010100001000010110110000100001100001100100
00110100001000100101001000100011010001000100001010100000100000000000010000001010001011000001010000010
00001100010001010011111000010010011000001000000001100001000000001101001101010000001001101100101000000
00010001000001011000101000001000000000111010000100000000111010100011100100000000101010010110100010011
00000111011001001001000010100000101010011001010000000001101010100000000110000000001000000000010010010
00010010101000101010100010011000010111100001000101000010100000000101001000000001000001000000000010111
00000000000000000001110001000001100101000010000000001111000100011111000101000001111010000000001001010
01010100101010110001001100001000011100110001100100011000001000010000100000111001000001000100001110100
10111100000001010001100000101000001111000100001100010000001010001001010100000000100000010001001111001
00000000001101010000110001000001010011010110000101000100010101100100000010000001000000000000000000001
00100001010001111000000100100000101010011010000010000001000001010000001000111000001000101000000010000
10011000000010001000000100000100000001001110100100001111010100001000011001100000010000100100000011010
00110000100010001001101000000001010001000001001000100000010011010101001100010000000011000001001110000
00010010011111011101010000010001000000010001100010101000001010000000100101100011000111100000000000100
00100000000000110001100000010000000110110011010001011001101011101001000000100000101000110000001101110
00000111001010000001111000010000000010001100000101110001000010100001000000000010000110001100010000000
01100010000001000110100100100011010100000101100000001000010001001110000000010000110110001100000000100
00000001001101000000001000001010000010001010001101000000000010000001100011010101001010010101011000000
01100000100000001010100110000010001001000000100000010000100000000000001111010000001010000001010000000
01001010110101011010010101110001000010001010010000100101100000100000000000010010100000000000101101100
01000001100000000111000110001011000110100000011000011101100000000000000100000101010011110011010100110
00101011010010011100101000001001000111010000010110100001100010100010010100110001000000000000000111000
10100110000001100000001001001100000000000001011001101100001111010010010101100000100001010100001100000
00001100100011110000000100000101010000001000000010001000000010001010010000101001000001001011001001100
00000010001000010010001001010000100000000001000011000110010100011100100101010111110010011001110000100
01000001010011010100110000010000101010010100100010000101000000001000001100010001010000111100000001111
01000010001011000100010000110001101001100100001000100000010011010100000000010000000000101000101010110
10000001000000000000001000000100100101110111010001101100000001001001000000001111100011010001110000110
10001010010010010000110000110111000100101100000111000000011001010001000001000101000101001111110010100
00100000000110100000100001010011011010110010010000010101010101000001110100001001010101000111000000010
10100100011000001000001100111100000110011010011000001001001011100010010100011000001011101111101000000
00110001111001010101110001001000000100010011110000001110000100001101000001000100111111011000000011110
10000000100001100011000111011010000001110000000000010001000100100001000010110001000011110010000101001
00000110101101000110100001010101000010010001101010110010001010100010110000001101100110000100001011011
10000111110100010000000000100100010100000010010000010100010111000100100000010010010000000010000000010
00000101100010000100100100010000101001010101000010100000110000000000011101000010001010000000111010000
00010000000110100000010011000100000000001000110000000100101000000110000110001111110000100010001000010
00001110110000011010011001110001010110010010011000011000000000000000000000110000000000000000001010001
01000000011010111000100000110010100111000011000000000100000001010000010011010010011101010001000101010
10000000000000000010100010110001100001010001011101000010110011010001110000010100100000010011000000010
11001000010000001100001010000100010000000100101001010101100000001110011000001010000000101010000010000
10000000001001010101001000011100000110001000010100000101101100000000010110000001100000000010010101010
01000000000001001001100010001000001110001000010100000101011001010101111010100001010001001000000100100
11111000100110011011000010000001001110011000000100011000001000101000100001001011100101000100001010000
01000000111100000001001010000010000110010001001100100001010001001110000011001010000100101000011100001
00111010001100010000111101010011000110010000000100000110110100001000000101000011000001101001001000000
01010010010000001100000000000000010010010010001000000000100000100110000011010010011000100100010010010
00001100101110100000100010100001110010100000110000100000111000010100000001100000000001000000001101010
00101110000000001101110010100000001101011100110011001001010100010000011110010000000100100000110000011
00000000001100001000110010100001001100100000000100010000011001001010010110101100011101000001000000001
10101000000000000000001100000000100010110001010100000000011000000000010100010010000000000100000010010
10000010001000110000000110001100000000100001100010101000100110111001010100010011000000001100000010100
10100011101001000100001100000000000001000010101001001001010110000100001101001000000000000010100110001
10110010111001011011000000000110000100000110001011100001000101000010000001010011000010100000000001101
00000111110000100010000011000010001011000010110010001101110010000110010010010000000010100100010011001
00100000000000010111101000010100110010010011111101001011000100101101000001001010000010001101000000110
00000000100010011000000000100000000100010000100001110100100000001000101000000011000010001001001000000
00110010101110100001000000101010011000000010000010000000011000000000110010110010000110010010010001000
01100000000100000001110110100010100000010010000100100101100000000111001001100000000010000000001010011
00000000010001001110000100110010000111000110010110000001001001000001000010011000000000100000000001001
10001010001010010101010001010001010000010110000000000011010010100100001011100100100001001000000000000
00010100010000010001011001010000010000110000010101111101110000001011000100000010100001101000010011001
00000000011000011100000010010000001000001010010000100011100100010100010100001010000110101000010100001
10000001101000011010010100100001000100000000000100100011100000000100000100001000101101000010000010010
11010000010101010001000101000010000010000000010100110100010000011000001001010000000000100010000100010
00100000000111000000000100010000000100000110010010000000000000010010000001100000110010000110010001000
01001111000000100110101011000001000001010010000010100010100001101000010001101100100001100000101000000
00000000100000101000000100000001011001000000001100101000000000001101000110100001000100001001110010010
00000110000001111101101111000011010000000111001100001100100000000110000000010101100011001000001000010
00001100000000010001101000000000010000000110001100001000110000001110100110000100000000000000000000000
00001000111101001110011101000011100000000000011000011000000001000010010001001101001101001000010000100
10001011001001001000001101000010101011011101101010100100001110100101000100000000110001011010000100100
00001000000000000000000000101101000000011011000001010100110010100100000001100001001100101000001011000
01100000000001000100000111000000110011000101000010000001100000000011000000001100010000011000010100000
00001100000010001101000110100101000000010000001100010011100000101001000000100000000000000010100001001
00001001100000000000010100010111010100010100000000000110000010111000100001001001110010000000000011101
00000010001101000110000000010010010001011000011001001000101011000000010000010000100111000001000010000
10110000011000001010100000001000000101000100011000000000000000010000000011000100010001000000000010011
10101100101000000010000000100010000000000000000010000000000000110000000100000100100100001001000100101
01001000010100100000010000101001110100011001000000011100110000010100110001001000000000100100100000010
10011010000010100110001100010110000010000000100101000011000111000010100001000001100011000101011000000
10001010100100011000010001000001111000010000010011010011011000000000010100000101100000001011000100000
00101011000100000001100100100010000000001011000000100101000110100011100001000001110000000010100001000
00110000010001100100001001000010100100001100100000000100100010010000001110100110110000110100001110000
10010111000100000010001000010011010010100001000000000000110100100110000000001001000001110001100011001
01000000000000111010000001111001000010000000100101000001000000000010100101010010010110100010010111100
