10000100000000100001001110000000000000011001100101100000100010101010010010000000000101101001111001101
01000010001001000000000101000000110000011001000100000001010000101000011000100000010110011101001000111
00001101100010000010010000110000100000100011010001011100110010100000101001000000011000010010000010100
01010000001000111000011001000100000100100010110000001010000100011010100100111000101000010100010010001
00001011100000010000001100000000010100011001000100011100000000010010010010000000010110110000001110010
00101010000110100000000011001110000000010000000000001000000001101011000100010000001010110101000100000
00001000000100010001001010001100000011010110010000110010000001000011000000000000001001000010000000110
11111101000000001000100100110110000000110100000001100000100100000100000000000100010001010001011010000
00000000000011100000000000000000100111000010110111110111001100100000011100000000001000001100000000101
00000110000000110010110000000000000000010100010100100010000101100101000001110001010000010011000010100
00001001011000110110000110110101010000010000000010000001000011010100000000101000010111000000001000101
00110010000011100010001100000010011000000011011000010101100001000100000000010011010001000011010001000
00000100100000000011000011001000110010010000100010000000000100000100000101001000010011010000000000100
10000110010001110000000001000010101110010000011000000001010000000001100000101100100010010101011100000
00000000000010101000110111000000100000000110000000000011110100010111000000000110000010001010011000010
10010100000001110101100000000000101000000110000000000000111000100001001000100100000100000100001100111
10011110010010100001011000000000010000100110001100100110000001100000000000100000000111000110000010010
01101001101010011000000110001100011110100001000010000010100110000001110100100011000101000011100001010
01000010100100000010100010100001010000010001101001010001110000000010100001000000100000000100000010011
00001000100000100001101000000000000010111100000000000010110000011100010101100010010001000010000001100
01010000100000000010000000100100111000100101111001100000001000001001100000101100001100000110001010011
01010101010100101101000011000001000100001010010001100100001000000000001001110001010011000100011001111
10101100000010000101010001000000000000100010000001000000000010010111000000011000101100010000010000000
01111010100010010000100000110000001000000100111001010110010000001101010000000110000100010001100011010
01000000001011001000000000000100111110011010010000000010000011100011010000000010100111100000010010100
00101000010000011010001101000100000101000100010000000100000000100100001010010001100011111010001010000
00011000000001111010000100100001011001100110111001000000011001000001000110000001000001000101000000001
01100010010000010100011111001001110001000101000100110101000000100001010001000001000100001010000000001
00001000110100000101000100100000000110000001000000000000100001010000100000010001010010101000000100001
01000110100001000000100010110100100000100001011100000000001010001000100000100000100101000000100010110
10000001010010101000010000100111000010110000100001011000010000000000000110000001000000000000000000010
00100000001010001010001000000000000101010100001000000010000100000110100000110110110101000001001111001
01101011000000001101010111101000000001011001000000101100011100010110000100000000100000000011000101111
00101011000010100101010000000100000000001010000101000101000001100011010000101001010000000100001000000
01000000111000101010001100100010111101100000000111001011000101011010000110010011000001100111111011110
00010000010000100110000010100011000010011000010000000000101110000000111100110000010110101110001000011
00011010000010010001101010110000001100001011000000000000001000000010111101011011110000001011010100100
00001010010001101010110000100000010010110000001010001100110000100010011010100100110000001110100001110
10010000001101011011001100000100100000001000111100100000110110010100010010001011101101100000010110001
00000000000001001001000011000001011011101010000110010100100100000011100100000101011101010010110100101
01001001000000100101000100001010100000000010100000110010000000000011101001101010010000000011011001010
10001000000000000010101011010100011110010010110011001000101001001001001000001100010011000000101000000
00000110000000101000010001101100011000000100001101100010011010110010011000001000001011000100110000010
01101100100010001100000001101000000111000000000010001010010000110000000000011011010001011100001010000
00010010001001110101010101010000101101000111000010100000101100010100000000100000001010001100000000000
00000100000000001010000101011100000001001000000100101001010000010100000000010000000000100101001000110
11000000000100000000000100100001100001001100001001000010011010010110101001100011100010000101110010100
10011001101000000001000000101010000000101110110010101010110110110001111001000000100001100011000101110
00101000010100100001000000110001110000000101001100001000000000100110101101000001100001011000000100000
00000000010110000001000001001000010000000001000010000010110101001100010110000000100000100101000100000
00000101000111101001100000001001010000010101100100100001011010000000000000101001001011101111001001000
01010000100000100100010111101010100001001100101000100000000000000001101001010000001101010010011010100
00010101000001100000010000000011000000000001000000000100001000011000110101111101001001001000000100000
00000100001000000000100010010000000110001110000110000110011100001000001000010110001000000001011100100
10001000001011011000101010100111000000011000101001100000101010000100000101000100000000010000010000001
00000010000001010100100100000010010000000000001000010000000100011001000001000001100111010000010001001
10001100110101001001111000011000000111100011000000010100010100000000111011000001001010000011010100010
00010101100110111000111100000000001000000000100001100001000110000101001000100000000000001000001100000
01111100010010011110100001010100000100000000010010001010010000000110000011000111111010010000101010001
01000000000000010001111011100000111100000000000100010001100010101101111000001100000100011000000100001
10000100100100001011111010000000000100000110100000000011000000000111001111110001100000001000010101000
00000000101000000100000010100011010100000000000010110000000001101010001001100110110100001100000000101
00000000110011010100001100000010110010010100100101010110100000011111010001110010010111000000101000110
01100010010000110010110000001010111101000010000011100000011000110010000000100100100000000000100110010
00001001001000100000010100000001000100010100010101110010110010001011001001000000000110001100110000011
00100101000010000000001100101001101000010110101011000010010101010000000001000011000000011001000000011
00010000001010000010101100000000100000010000100100001100000001111000001011000100000000000010000010000
00000001010010000011000010101000010000100000000110000010001010110111000101100010101111000010010110000
00100001000110001110101100010000000000101010001010001010010010010100101000011000001100001000010100000
01000011000010001110110110100010111000111001010000010100110100000100010000000001000010001100100001010
01000000100000000011010000000100000000000100000011000011010001000100000000000010110100000000000001000
00111010001000000110000000000000001000110001010111000000000011010100100000000010101100000010101000001
00000011000010100000000001101001010010100110000110100110010110000000100000000011000010101100000000010
00001000000010110000010000101101000000000111100000000100011100001110000000010101101000100000011001001
10100000010001010000010101001010010000001101101000000000011100100010110101011110110010011010101010000
01000000000010001000011000000110000001001100000101010101100010101101101100011010000000000000011000010
00011100110010110000000000100010001000011011000110100000101010100001010110001110000110100000001101001
00000100000000001111000001101011001000001000000110011111000010100001001100000000110100101011000011010
01100011110000110000000100000010001000000000001011001100100000000000000000001010101100000000110100111
00001000001010011100001001000000100000101010010000010001100000110000101010000001100000000110101000100
01000101000011001100000000010100101010101100110111100001011110001110011111001000010100000000000000010
00100000100011001000000000000000110000011000001011000001010001001100010001101000100001000000000110010
10100000011100001000100000000010011100000111001110000001000001000100100100000000001000010000010000101
00010000110110000001100000000101000110010101010010100000000010000101111100100100110010000101000010011
10100101001000011011010000010110000100100000010000101000000000000000010000110000000011000101000000000
00000011000001000000000100001000101101110000100010101000011000000001011001100001010101100100100000100
10010011000001010000001000000001000100000101010100000001000011010010000010001000110000100000101010010
00000101001100000010010110011010100001000010010101100001001100100000111000110110000110001000000000001
00000000100001101000111110001001000000011000001010000100110000000011010100010011000001010010100000001
00001010000001001000000101001001101010000000001011100001000010100100000110000000001001000101000110100
00010001010000100111110001001000000010001000000010001100000001000000010000010000000010000001001001000
01001001001010100100011000110100001011000011010100000000000000000000000000110001000100010000001101001
00011010000100001000010001010000010100101000010000001100111001010010000000011011110100001010011000011
00110001000000000000111000000100000110000010101100000001000000001100101111010110000100010010000000001
00111100010100101101100010110000001101000011010100100000000000011101001001010111000000000000000000100
00000010001100011001000000000001000000001000010100010110000001000010001000000000110011101000001000010
10100011000001000000101110100000000011001001001100001000100001100000101100100000100010010101010001110
11000000111011000000100110000001010000000011100100001000000100011000010100101111000001010000000000011
10000011100000000001100000100001100101101101000000101000010011100000000010000110011100000010000101011
00000000010000100101000000010001000001010000100000011001000111100110000101001010100010000110001100000
00111111010000000010010000111001010100000100000000100000001001101100000000011000100001000001000100101
