00000100001000000000110011000000010000001000100010000100001101000100101001000101011011000010100000100
00000010001100110110000000100110000010110100101100000000011000101010000111100110000010000000110000000
00011000010001010110000100000010000000000001000001001100101000010000010000110001101111110101000101111
00000011111001001000011000010110101000000011100000010000100101000001100010011010010001010011000000111
00010000001111001010000000010000101100001100000010010010010100010000000101001001010001011000100110000
00110000000010001000000111001100001101000001000100101110001000010000000011000000010000010000001100100
11000000001000110001100110100100000000000000100010110100000010010000101000001011010101000101000101011
00000110010100000110110000001010001010110001011100010001010100000001111000100110000001100100010011000
00000010000100000101000000000000010010010000000000000110100000010001110001010001000001001011100001000
00001100001000000001000001000010011000000010010100001001110000000000001000010001101001101011100010001
10101000000000011000010100000000000110001000100000010101110010100010010001001100000010110001011000111
10010000000001000111100001100000000000000010010001010000111001001000001000100100111100111000100001000
10100010000001000010011010001001000100000000001010000000100011011110100000100000000000000001101001100
11000100000100001100001010110000100001000001010100000001000000100100000000000000010000000010101000010
00100001000000010000100000010100101000000000000011001000010000001010000011001100000100010001000000000
00110000000100000001010011100101100100010001010110000011010000000000001000110110000000010000000000100
00100010100000000100001000010001100001100001011000000001001100000000001001100001100000011000001001001
01000001000000100010100010000000011000100101010001000000000010001100100101001001000000010110000000000
10010000111010010000100000010000000000000010000110000001110000011010010011000000000101000010110010000
00101001110011100010000001101000100000000000001100010000111000011001010001010000000000011010100101110
10010110000010001101001011000100000001010100101000011000000100000011000000000100000110011000001101000
00100000000000011001010011010001000001001000000000000011000001001010100001000000000100000000000111001
00100101100001100010010101110001100001100000010101000010000000110101000001001100111000011001010010000
00010000001000000000011000000100001100011100011000000001100001010111000100000000100110001000000000010
00000001100000111001100000001001010010000100111000111001000001100000100100010011001000000110101010100
01110011000100110000100001001000000000001000000000000100110000000100000000000000010110000000001101001
00011000001001001001001010010110110000100100011000000000000000100100101110100010010100011110000001000
00100000110000000010100101000111001110101101000110000000000001000100010000110100100000100000010000100
10001010100110110000100011110001001000110101010010101011110011000000000011100000000001101000100001001
01010000110101000110000001100000000000010000010001100001001000000010010000000000100110011101000000000
00010010001110110000001000011110000111001100000010000100000010000111000001000001110100001001110010011
01000000001001110101000000100000101110000011001000001001010011000001010000100000010010010101000101001
00000000010011010000001010000011010001010000110010000100000000001000100101000001001100001001100001010
01100101000100001001000100011000000000000000100100001000000010000010011011000110010011010000101000000
10000000000000000110001010001001100001100010000001001010001010011001000100010010110001000001001010011
11000011110001001000111000000000100100101000000000001000010100000010100011110000011000000000100001100
01111101010110000000000101100000010000100011101100000110011011010000011100100000010000000000000001000
00100011100000000010110001001000001100100010001001010000001001000110001010011100010110101000000010001
01010100001000000100010000100010011000101110010000000000001000000001001001010000101001110000011000101
10100100000000100010001010000100100010110000100000001010000101011000000110100000010010100001100000000
00000100010110001110010100000000100000001101001000000100010100000010000000001000000110000100000001000
00010000000001100000001101010000000011100100100111110000101000000000000000010100011010001100001100100
01010000000000000010100100000110100000010111001110010000100100100000010001000011001010011001000100000
00001010001100011001010001110000000001011000000000001000000000000100010001001000000000111101001110000
01000000000110010010001000100011001000100110100000100000000000000101110000000110001010100000100000000
10011000000010110100001001000000000010010000101001010001000000000010111001100100000101010010001110000
00101000101000100100000000011100110001011100000010101001000000011100000011001000000101110000000100101
00000010100011010000110011010000011001010000000010010000000000000011011000100010001001100101100100000
10010010000000000000001010111101100010010000100000000010000010101100010010000000000000100000000001001
00000000011000000001000000000001100000000010001000000001000011100010001000000100000101000000000001000
01010000000000010000100000010000001000100110101011100101011100100011000101001001001100000101010010000
10000000000000010110000001010000110000000001100000000110001111001100100001101000000010000000110000000
01000000010000100001001100010100101001000101100001101011010001100100001000100010001100000100011101001
00110000100000000001100000000000110000000001000001001111010000000000100101110001010100100101100010000
00001010100010011001000011001001100001010011110010100001000111000000110101100000100111000000000000000
01000001000010010100100000000010100001100000101000101011001000000010110100011010010101011001010001001
10000000010110101100000100001000000100101000001011000010000000000100000000000001001100000001000000000
10010100010001001100100101110010100010010101000101011001010000000000011000000011100001010010100000110
01000100000000100000000010100110001110010100010001101000000011000001011101110001010010100111000110110
00000000000100000010000100000000000001000000110000110100000000001100011010000000010000100000000000100
10000010100100000010011010100000101001010110000010100011001000100000001110010010000100001001001100001
01101010000100101010101010111001000000000000000110110001001001100000001000001000000000000010010001001
00010110000000010100001110110001000000101001000000010010100000010000001010100010101000000100000001110
00010010010001000000000010100010100101000010001011110000111010000000011100000001000011000010100000100
00010101000101100001100110010000001100010001100001100000100010001000111100000110001000100011000010000
00010010000010000000000001000001101111000101011000001100100000000001000101110000100001101010011001011
10000000011000000000000010001000011110000011000000111010011010100000010000100011100111001000011001011
10010011001010000110000001000000001111010000111011000010001001010100000101100100000000000001001110110
00000000101110001100100000000010101001000001001100000100101101001100001000100100010100001011000000000
10001000010100100101010100010001000001001100000000000011011010100001001101100001000100000001101110001
10101000101000100000101001000000101000001011110000000010000001000101100000111000101010001010000010000
01010001010111001001000001000100000100001001000111000000000010010100000000001001100100010010001000001
00011010100000100000000000000000010011001000000100001010000010010001000101010100010000010100010100000
00010110110001001000010010001001001000101000101001001010001000000100010101000010001001110011110011100
00000100011010001010010000000110011010000001111010000010000001000010010000000000011010000001000000011
10110011101100011000011011101101010100101000001100010001100101010000010001110000010001100101100001001
00010110000000000010101000001011000000000001000000011000010001001011100000000000000001000000110000001
00000100110000001011000010000001001100100000000101001000100000000001001010000010001000011000000100000
01001011000001010010000000100100101000011100001000001000001001010001101000100000000001100000001000000
00100000010110000000010000010010011001000000000111000100100110000000001100000001110101000100000001010
00010100111100010100100100100001001101011110100010010001100001000110000100001000010000000001110010111
11000000011000000100110101100000010010000000010001110100000000000000011001100010110101000100010100000
10000001010001011001100010011100001000000101110000101011100100110000000010101000000001000111101001100
11000101110000011000010011000001110011110100100000001000100000100001000000010000011011000100010000000
10000001100011100000100001011000000011000101100000000010100000010000010011000011010101000111100000000
01000010010000100110100010010000001100000000001011100000011000110100001001010000110111011000000111000
00011010001000100110000000000101000100011010011000010010100101011000000000100001001000101110001001010
01001110100101000010101001000000000000010010011011000010000100011001010000010001110000001000000000001
00100110011001011100100100000000000001001100000100010110000101001000011010001001100001000011000000101
00000011000000000101000011101000001110010011000000001000010000001101010000011000101010100011000101101
00000000001010000100010101010011010000000000000000000111001010000010010000010000000111100000101000000
00000010010000000000110000000000100001010010000110100100000000010011001011000000000100100100001110000
11000001000000100001001110000000101000010000100001000101001010000100010100010000011100000010100011000
00000000010100010110000000011000001000110110010110000010010010001101000101010100000100010100001000001
00010000000010001100110000011100100010100000000000000000010000000010001100010001100010000001000110010
00010011000010100000000100000000111000001010101010000000000000101011010100101000100001100001010000111
01001000010000100000100100100000110000001001010001100000001000010101001101000011101100010100001000000
00010000001010101101010100001000011000000001010000011010001000011000000000100000010000010000001000000
00001000001100000100110001010000010000010010101001001010000111100100100000111000000000000001100101110
00011000000000010001001000100001000010100001110100101000010110010000100001011000010001001001100000001
11101000001001100000001000111000101000000000100010001101101110000010010011001001000101000010010100001
