10011100000000100001000010101100000001100000100000010000100001100000100001011000001100010001010100000
00010111000000111000000001010000001000000000000010000100000010000010000100000001100010110000101001011
10011000011010000000110001001011000000000001010101011010000000000011000000000100000010001110001100000
00100000111000000001010010100101111110000000100110010010100001000000100010101000110010000010010100110
01100011001011010000001011010010010110000000010000110010000100001110001100010100000001000000100001000
00000000100111000001010011000010010000000110000100001000110000000100100100010000000111000001000011000
11010111100000010000000000101110110100010010100110000100001101000101000101000011000010110100101000001
00000000000101000011100001010000000110100000001000100100010000011001000000000100000100110001001010000
00100111010000010000000000000010000000101000100000000101100100100010001011100100010000011000010100100
00000001011010100100110000001000100001000001010001000000000000000001001011100100000000100000100000101
10000000000000001010000010001110000000010001000001011001000100100101000011011100011101010110010000000
00001000010010100010111001001011000000001000100010001100011010100010000001000111011010011000110010111
00011010000110000100101010000101100110001100011101010010100111100101101000010000000000000101100000111
01001111001001000101000010100000000001010000100000010000000000110110011010000001000001000001001100000
00000011111001000101100001100101100110100001000001000000000110101000000100111010000110100110000111000
01000001000100000000000010010111000000000000010100000000001000100000100000001100010100101000011011000
00101000101100011100100010010010000010001100101101000000000001101010100100110001000000110000010000000
00110001100011100010001001010000001001011001001101010101110001100110000101000101000000010110010101000
00010101001001001000100001010111000010010110010001110100000110001000000000000110010000000001010000101
11010001100000010000100010000000000100000111010000001001000110000111100110000011100010110000010101110
00011001000000011000010000000010001000001000010010001110000100000100010101000010001000010000000000000
00000010001001000000000000000010100000101000100000011000010001111010111100001001000000000000000000010
10101001100110100000000000000000101000111001010010000010101110110000010000100011000001000100001110011
00010000010011101011011110001001000000000010000000100011000001000110000000000001001101001001000110101
00000000110001100010001111110000001000010101000001001010100100000010100000000001010001010010100000010
01001000000110101011001001000000000000000010000000000000100100000100001000001000000100000110000101001
00000100010101010110100001000010001111010001110010100001100101001100001010010011101000001001110010000
10110000010100100001000000000010100000000000110010100000111011001110100000010001011100010100000010101
10000001101100011000101110000001101011001001001010000000000000001110000001000000000101000000010101011
00000000000000000100100000000010010010010010110000000011100100001000000000110000101000100100010000001
00001000000001000000001100100000000111100010101100000100100001001000000001100101110001010000111010000
00000001101111000100000000010000100000000001001000100000000100100000100001010000110000001000000100100
01101010001110100001101001001111111001010000010011101001000000010001001100000011000000110110001100010
00110100000010000001000001011111001001010100100110000010100001000000000001010001000000010010001010001
00001101000000001000100000100000001010000000000010000100111000010000001000001000101101000000000000000
00010011110001000000101110000000010010001100100110001110111000010010000000001001100001010011111001000
10100101011010011011111000010001001000010111000100011000100000011100001000100010110100100101010100000
00101000110110101110001100000000000100000001000101111001001010100010000010001110011100000100001000000
00100000000101011001001101100001000000001110000100000001010000011110001000010110000100111000011101001
10100000010010010000000101011100000001011000000100000000101011100001010100000010000000001100100010000
01010001101111000000110000101001000000010010000101011110011000010011000001000100010101000001001100110
00100000000010001001100110000100011000010000011000000101010101000000000000000000100110000000001001000
00000001110100101100000010010001011100001110001110010100010111000110101001100000010000001010001100000
00001001001101101000001111000001001110000010100110110000011001011001100001001000000101100110000101000
00100001001100010101001101110000001010001000110100000001010010000001000000000000001011011000111000011
10000001000000110000011010110000010010100000001010110000010101010111000001000110100011110010110101001
10011111001111000000100011011111000110001101000100101100000001000100100000000110011000110001101010001
01100111010010100100010000000000011000000011100000001100000001000100100000010000110110010001011000010
10000000001100101000100000000100010001000001100000110000000101000101100000001110001001101100000001100
00000000000000000110011000001000110100000000000000101101000010010100010001000010111010100001010000000
01010000000010100100001010000000010001111000100100101110100100010101000110000010010110001100000011010
00011001001100000000011000001001000000001100010100100100000010100010010000100001001000010001010000000
00000010100110111011000101100100000000100001100000000000010001011010001001010000010110011111110010001
00100001001000010100111001010111100101101101010110010000011100111010000000000001001100100000101011110
10100001000100010001100000000011000000110000010000011000010100000000100100010100010111110011010010010
01100000000010000000011000010000010000001011010100101000010010001100100001001000000010111000011110010
01010001100100001001110010000100110100010000000010100000010001110100000000100010000100010010001000000
00000011010101010100000101000010100001000010010011000001000100000011100101000011011000101001010000000
01100011110000010011001110001001100001000001000110010111101010000110100110011100101010000100100000101
00010010100001110001010001001000011010001001100110001010000000001101111000000001101011100100010000001
01111110011100000000101010000000000000010110011101101100101011000010100010010000010111000100000010110
01001000001000010010011001000000100000110001100101100000100001001100010000000011100110000100000011000
00010010000001001010000110010001100010011000001000000100000011100100010010100010100000000100100000001
01000000001001100000000000010000001010101100001111001100000011111111000001100001100001000001001100000
00010000001010101001010001010000010000000000001001011000101100001000001100001000100100000010000010010
00100110110011011000110011000001001110001011000001101100001100000010000101001000000010000000010010100
00101000010001001000001011000001100011000010100010111000000000000010010000100000010000001110100000010
00010101100001001100000000010000101001001100101010001000000010000000100110101011100000010110000000100
00101100000000000100000000000000011000000000000000000010000010110001011000100000000100001000010010000
00001000000000000000000010000100100010001000000000000100100010010000000000000010000010100100000111010
10010000100000000000110010010101000010000010010001100010001000001010000010100100110001001000100010010
00000000001000010100000000100000010000010010010000100001011001100010000101000011100000001000000000011
00110110000000100001000001000010100010001100100000100001000000010010011000010000000110000011000111000
00011010000010100000100001010011000011010000000000001000100010100100110100100110101000100001000010001
01111101011101001000010011000100000000001000100010000000100000010010001000010000010000011000001000011
10001000001100010100000101011100000100000100000001011100000100010100000000000100110001010010011100001
10100000100000101001100000011110010111010010001100000111000010100011000001011000110001100011000000100
00000111010000000000000100000011000010100101001000000100000000011000000110001100000001000000010000100
00001011000010111100000010010101000000010011001010001001110000100000101000010000011000000000101100000
00110000010001101000010101000000010001111100000010001000011100010010110110001010100000100111000000000
10000011110000011010001100000010010100000100000000011001010000000000011110011001101001101100001001001
00100110100010010010000100000100111000000100000000000010000001110000000100101000110000000100010001010
00110000000010001011000010001000101101100010011100100000010000110000111010000011000110110111010000000
00001001000100001101000100100110111100000000111010010000000000011000000100001001100100000100010000100
01101010100000010001000011011100001110000000100001001000101000000110000000010000010010010000000010110
00100011100110000010001001000100100000000011010001101010100000110000000101010000000010100000010000101
10000001000010000101010011000101010000011000000000001000101000010100100000000100000011000001000100010
01000010100010000010011101000100000111000001011101110110000001010000110011101110000100000101101111010
00010010000100001001100100100000101000000000000001010101000101001010101100010000000000100001101001110
00010001000011000100001110000100011000001000100001000100010100010001011000001100100100100010110011100
01001000101001000001000010000000000110001110101101001010000100001001101100110000101010000001000100111
00000000000010100010000100010000001010010001100000000010001100011001000000001011010110001011001001001
00110000000001000101001001001001011111010111011100110100010010000101000000010000001000010001000101000
00000110010000101000100010010000000010001001110000010100000110100100010010010001111100011010010110000
00001011000111000011111100000110100011110100001110000000111000100001101010110000010000011110001001000
01010100000000001001000110100110110101000010000101001001000100000110011010000000000101011010000001101
01010000111010000000110000101010101001001100101111100000110101001010010100001000000101100000010011100
00010101000001000010100001000011000000010000100101001000001011100101000101000000110010001010010100101
01100110000010100000001001001000001010010101100000000000010000000000000001000001110010000000101000010
00001100000001010000000001101110000000010110000000001110000110000000100000000010110010100000000010100
01101010001000000000000100110000001001100001110010100000001100000000010000101010001100101100010000110
