10101001100000110000000000011100001000010100110100000100100100101001011000100011110111110011100001001
11000000110000100000000001001001000000110011100000000010011100000010011110000010100000010000000010010
00100110000000111000010000000000001000101000000001000000001100100001000111101000100101100001000110000
10001000000001001000010000000100000000110100001110010001111001111000000110010001000000001000000110000
00010011000001010101010010000000111100000000000111010001010100000001011001011001000001101000100000010
10100110011000011001010000000000010011000010001001100000000010100001000101010000000000000000001000000
10010001011011101000001100010110010000011001100110011010110100001010100000100001010000001111100000000
01110000001101010001010000100101000100100101010110100000001000000000000000100000111000010001000011000
00000000000000100000100001010101000100000100010100000001001000000000000101101011000100000001010000101
10010101110000000001100010000000110000000000000000000111000010011001001111100001111000000001000000001
00011000000010100000000010011010011010000000000010000110011001100000010100110101011101101100100001000
00100000000000111010001011100000101101000000110101000001010000000110010000100010100110000000010000001
00000010011011000000100100000100110000100110010000000001000000000000000001100101100010100001001110001
00001011110010011000000100000110000011000011000000000101010000000000010010000101000000001110011101001
00000011100100001000001010011000010101010001110000000000000100000000000010000101000011010110000100001
00010000000101000010000110000110000010011000110110010000000110001000101000100010100100111000001100000
01110010110010011000011100010000100001100100001001000000101000001000000101001010110001100101011001001
00001110000001001111011001110000000000100000100001010000100110001100000110000100001010000100101100000
00000010110010000001010001001110100000101000110010001011111000000010100000011110010010001101000011001
01000001000000110001000010000000100010000010110011110101000101000000110101010000000011100001100011010
00010100100000110111100000001011011001010001100100010000000011000000001000100110100001001000100100011
10110011001010001111000100011011011000100001000110100001000010101000000011000100000000000000011000110
00100001000001110111001101000000000000100010100100100000111000010100100110010101100000001001000000010
01000101010000000101001000000000000101001100000100101110100100001000000000000010110100101110000000001
00000000100000100000001001110010101101100100000000101010100000011101000000100000100000000011001000001
01100001101001010100001001111000010000011101100100100010011010000001001001010111000000000000001000010
01000001000110000010000001011000000111000000001101011011110001011000101000000110010000000010000000001
00100000010001100000101000000010000111001000100010001000111001100010000100110100100000001000001101110
11110101110000000000010100100101000010100100101110101010000000000000001100010011010010000011001000010
00000001010010010101010011100001010001000000110000000100001010000001000110110000100000100001000100010
01100100010100100111000011100100000000000010010010010010000111110010110100000001100011000010111010000
11000011100101100100000011101000000000010100001010010000001010001001010111000000101000011010110001000
00000010100000100000001011000000010000010001100100010110110100100010000000000000000010010000110000000
00011000000100000010100000000100000000000001011000000000001000000000010011010001001000010000000010000
00010000110011100000010000000010000000010001001000000100010010010110110110001101100100100000101100011
01110110000010000000010010110000000101000011010110010011001101110000100010000011000000001000100001100
10000010110110001010000010010101010000000111000100000000000101010000001100000001010001010000000001001
00010111000100000000101111001111101101000001101000001100100011000001001000010000100100100001001011010
00010110001010011001100010001000110100000110010000010000110101011100001111000110000010000000010011000
00110001100000000101100010000000011100000110001000001001000000010101010010100001000000100011001001000
01011000010000111001010000010110100011000000000000001001100101000000100001000111000000000100001000001
00100100010010000000101011010000011010100001010101011100001001100000010101000001010000100010100001010
00010000100001000001110010011000000000000000100000101001000100011010011000010000100000101001100000000
00101000000100100000011011001000100010001011100101000000010000011001010000000100110000001101000000110
11000000000011100000110010100000101010100010011010010000001101010000000001000101001100000000101000000
00000001000111011000001001000100010100001010100001100000010000000101000000000100000100111000101001000
10100001010001110101001000000000001001010101011001101000100111000001000000001001001000000000100100100
01000001000100001000100100010001000000001111000010000000001011000101001010101000110100101010000001000
00000010001010000000000000001110000001010010101001000101001000000011110100000000111001000100000101001
01101010000000011011001111001010000111011100000100010100101100000011000001000000010010101100001001010
01000010000000000001001101100000010000001110011100011100000010110000100000100110010010000000101010000
00101000000101001000101101000001000000100001101011000000000100000010110110001111100100010011001110101
01000000100101000100100001000100111000011000011011110101110000011010000011011101010110001000010110001
10000001001111000000000010000010010100000010100001000000001000001000000001000000100100100011001010010
00001010110010110001000100101001101100001100100000001100000000001010010101001001101000100000100001100
00001000000000011000000000100000010011000000001100100111000110010000110000111000000010000000000010010
11010000010001000101000110010001011001010101010000001001100011110010010000110110011000000010000010111
00100000011010000100000101111010000001100001001010000000011001110100000000101000010000010000100000001
00101000011100000010111100110001000110000110111000000000000110000000001000110101000100011101000110000
01000000001000111100000000001110100000000010000001000111000001000000000011101001000010100000010001001
00001010001001001000000100100000000000000000100000001010001101011001110010010000111000100000100000110
00010101010100000000000001001000100111000000000000100011010001110000001000001010000001001000110000000
10001000011000001000011010000000100000100101100001000000000010000111000111100111000010000000000000011
01000000000110000000001011001001001010100000000000000010010110100100100000001001000100101010000111011
00001000101000000010100101000100001010000000011100000000001100010100000010010011001000110101111000001
00011111001011000110001000100000010101011000001000101100000010001101000000100000000000010011000010000
11000000000000010000100111010000111000000000010100000000011000000011000101000100010010000100001001010
01000001000010010101001000000000010100000000010000001111110000000000010000001000110000100011100000000
01000010011010100010000111100000100001010111010111000000001001000000110000001001001001010000000010010
10000000100010000011111000111001001010100100101010000000001100011011000000011011110010001000100011001
00000000001001011000010000100000101001010000001000000100100011001010100100100000001110100001100000001
10000001001000000000010100000000110100011010001100000100100101010000000100110000101000000010000100001
10000000000101000100100110101010000100000101010101100000000000001110000000010001001011010110001110000
00100100110100001101001011000000000011000000001100000110100000011000001001000001001010000000000100110
10000100110011101101000100101100000000000110110010000000001000000000010101000011000001100010001100000
10000010010100000010100100000011000000100000000000000000000000000100000100110100111001001001110010000
00000000000100011101001000010001000100011000010101110000000010010010000001100110000100001010100010101
00001110000000010010110000000100000000010010000000000000000000000010101001110010101110001010010010001
10100101000000001001110111011100100100001010000111100011100100000000010100011011011000010001000010101
00000000000000001000011010000001100011110000100010000010000100110000111100000000001000010010101000000
11100001100000100000100010000010000100111001100000011010001000100000000100001011000100000000000011100
00000100000001000000100100011000000000010010110100000000010000110010100001000000000000000110001100000
01100000001000011010110110101000000000110000001110101110011010000000010000010010000001000000000100100
11000000000000110000000010101000010000010000100100100100100000010000000000000110111000010001000011000
10000110010001011100101000111011011001100100110111010010010011010001000000110001010100101101000001001
10011011110000011110000011000110010000101110010111000010101001101011000001000100001000000010010011100
00100000000101111100110011000010100001001010010001101000000110011010000000100000000000101100010101010
00000000000000000011100000110001001100000000101101101101010000001000110000000100000100000000100010000
10000010000000110011010000000000011011001001001101110000011000000000100110001010100101001111001001000
00100000001010100000010011101000000011110000010000101000111011000011011101100010011000010110000000001
00011101010100001010000010010000010011000000011001000110011011001110110000101000000000000001001000001
01000010001100000010100001011000110010111011000110000010000000100010101101010010000000011001100010000
00010001010000010000000010100110001000011100011001000000001100001001000101000100001100010011011111110
01000001100111001000101011100011100100010001101010001001000100100010100010001101011001000110000100000
11000001011000001000010101001011110011100100000011000001001010111001000000000001010011010001000101100
11001110000000000110001000000000110110000000000000111001100110010100010000000010011000010101101010100
00000010010010000001001000100110110001011000010000100000101100011010100011000000000001000000000101101
01000001100100110010010010000111000010000000101100100101001100100101000010000000000110001100100000011
10000000001011000100100000010000010010000000001001000100000010000000001000110000010011000001000001010
00000000001101011001001000001010001100000001011010101000000000010100010011100000010111001010111011001
00010101011000000000100010000011100010000001001000100000100010010100011110000000011100000100001100001
