01101100100100001000100100011001000100001000100110000100111100010111100000100010101000000010010001000
00010100010000010001111011010010010000100001000110000000001010001111000110100001000010010011000000101
00001100001000001110100010101011101011010010000000101101101011010100000001001010000001001110000111001
00010101001100000010010010000000000000100010011010001110100001000101101000000010000100010100101000001
00101001000001000010001100011011010010011000001001000001000001100011010101000000011000001100100011100
00010001010001000000101010000110101001000001000101000101000010111101001000000000000101000010001100011
01110111001101010000000100000000100010000000010000111011000000101100101110110110010110100011010100010
00010000101010000000011110110000010101100100010001001100000101100000100000011011000010001100100011010
10010101000010001000110000110001000110001111000111101000000001000001010001010100110001001000100011010
01111010100001000010010000000001000001011001110011010001010000001010110011000010000000010001000000010
10100001110010100000000000000100000101110110101000010000010000000000000100000000001101000101001110001
10000111001010000111001000000010001000001000100001100000100100000010111010000001001101001000000010011
00001100000100000001000000100101001001000000001000000000001000100000010000100001010000000000000011101
00110010000010011010000010010010011011011000100000010100001100110000001001001100000100101110010100011
11100001010001100010001100100100110000001000001000100101000000010001100010010000001001000010000001000
00000000100110001010100011000100000100010001001000010001010001010000000110100101001110110100001000110
00000000010001011001000000001001000001010110011100010100111110100000000101000000011010010001001111000
10101010000011000100001000011011000100000100110100100000010010000100000100010001100000001100000000000
10001000000010100000100110010011100000011101001001110001010100010100010100000001010100000100010000100
00010001101000110000001101000000101111000110011000000100101010100100010110001010000000010010001010000
00001001000000000101101110010000000100011001000000001000010001010000000110110100011110001101111010000
01010011101001110000111000000000010110010001011110110000010010100000100011010110001110010110001001000
00011100000001011011000000000001010101000000001010001000110001001000000010010000011100101100011101100
00000000110010010100000000000000010010001111000101110001010001100011010010000000010000010000000010010
10100110100000010110000100100010000000011100110100010001000011001001111000100000000010010010100000110
00010000001000110001101001000011000100000011001001100100101101010000001010011100000000011001100010111
10010001010001101011010000000001010000000010001001100000000000010000001100000000110001000000010000111
01100010110000000011011000110000010000100100010011000001100010110010101100111100011010010000000011101
00000011000000000000000011011001010000000010010001001101000101010100101110001000000000100100001000100
01011000100010001101100000000100001011100000000100001110000010011000011010000000111000000000111010000
00100011010101000110100001100000001010010000110000010111000000010110000101000101101000010000100010000
00001000001000000001100000000000000011001000000001010000001001101010010001000110100001110010000100000
01000000011010000000011100110101000110111000000011100000100000000110101001100000011100100000000001110
10100100100101010100000001000010011100000010110100001100000100000100010001101100101101000101000100100
00000010111000011011010111000000110011000101000100010100000001101101000010001010011000000100001001100
10001000000100001100000010010000000000101000000000000101001010100000000100110101110100001010000000000
00000100000100110001000000001000010001001011000100010101000000101010000001001001111000000100010010101
00010011000000001010000110000000100010111000000101011010010101001000010001110100001010010010100000000
00001000100000001000011000100000001100000100000000000100101001000000000000001101010100100010111101000
00001100010000111001000000000001010000011010000101000110100000001000010011010000000001000000000000000
10000100000000010010111000000100011010000000100001000100001001010001011010110001000100000000000000000
11011010000000000110000111010010110000100000000010100011010000100010100000100000001010001010000000110
11110100001010011000100001000100100100000101001000001010100100100100100000000010001111100000000001011
01101001000001001000001010000000000000000000111010110101010010111000000000100000000101001011000100010
10011010001000100111100000100000000000101000000000100001000000000110000000000001001001010000000001000
01100011010000001000000100000010000010001000000010010100100010000010001011000000110110001000010110000
00000101010100000000010100010000010110100011110000100100001100100010000000000001001001011000010000010
01100000111100000010000001100000110100100101010110011010101011101011000001001001000001010010000011100
00000011010000100110110010010011010000000101000010001000101111000101010101100100000010001010100000001
00001110100100101001010010000000000111100010101000000001110000000000000100111001000000000000000000000
11000100010000001100110011011010000010001010100100000000000011100110111010100001000000010000100010001
00001000000111010000001101101001011100010100111110101000000000000001000010100000000101111000000010100
01000011000000011011011001000100001100010100000100010010000100000100001101000000010100010001000000010
01100110100100000100001001010010111000011000100011000010100000000001110000010011000000000010010000111
00111001001000111100100000000110101000010100100110010000000000001000000001001011010000010010001010000
00000000000011001000010110001001000100101000001010010000100010110001001100001010111010101101001000101
10110000000011000000001100001100000000000110110000000100000101001010111100000100110010000100000000110
00101101100101001101010001000010011000001100000110100100000000000001010000001000010000000001000010110
11000000010000010010001000100010000001011100011110000111010101010000010100010000000000000010000111010
01000000010110010000100000000101100100001100101000110110110001100000000000000000100000100100010000100
00001000000001001100001100110010000010100100010010000110000111011011000010100110000001000010010000111
00100000011100000110101000010110000010010001000101001011100100000000010001010000000010011001001100001
00010011001000000000001000001001000110010001001010011100000001000000011001111101100010000000010010001
00010000100000011101011101000010110000000000000011001011001111011000010010000001010000000000000010000
10000010011010000001000000110100000000010001000001001010011100011001101010011010100111010010110100010
11101000001000100001101100100000100000010000001110010000001011100000111110000011001001000000001100100
11000000101100001010000010001000001111100010101001010100100000100010000001010100010010000000010000001
01000000001000010000000110000110000000000001010010101000000010100000101101010100010110111000111001010
00000101100001010010001000000000000000101110000000001000010000001000001000001100010000010100000100000
01001001010110110000001100100000010100000100000100101001001000001100010010000000000100100001000000010
00000000000100000000001000000100001101010100000000011110111010000001011100010000101100001001000100010
11000011001101000010010101001001101011000010010000000101000100001110000010100100010001000011101000110
00100000111011010001001000100010110001100010000010010000001001100000000010001010011010101100100000100
10100010000000010000011000000101010010000110101101100000100001001101100100001010000001001111001111100
00000000010001011001101000000000000111000000100001100100111001011000000000100100010000010011010010000
01000110000010001000000110100010000001000110000001001100000010110100101000011001000000001101000010100
11001011000000000000111010101010100010101000011000101001000001100010100110111010000000100100100011001
00011111110000000101000010011001100110101000010110001010110000110100010000000000100000000000011010100
00000100000000100000100000001110001000000001001000010000010010000000000110000000000011000100011000000
00000111010100100100100000001000100110000001100100001100000100100010000101101100000000000110000110000
01000011100010000011110001001111001100100000100001110000010111000010000110000110011110010010100100100
10000001011010001000100001001000000011011000101001000000111000000010100000000000000000110000000010010
10010001001000000000000001000100000001001000111000000000000011000010001010000101100000001001001000110
00001101010000100010000001001000010000100000110110000101011000010000001000111011010110011011101000001
10010000101100000001000001001100011001000100000101010011010000001010100100001000000000100000101010001
10100110100000000000101000000010000100101011000101011100011110000111000101011101000000000001000100000
01100000010001100001000000100000000011000101011000001000010100111000001000011100001010010010001000011
10110110100001101000000100110010110000000110000000011001001001001010011001010000000000100110001100100
00000001110001001100101000011100111000011001100000100010100010000001000010010101000000010001010101001
11100000010100000010100011010001001010001100001000010110000011000000101100100000000000000000010111011
00010001001101000001001010101010101000001001001000000011001001010100111001000001001001101000000000000
11001000001001101000000010100001011000010101110010001010100000000100110000000010010000000001001001000
01101000001010111101000010000101001011000000111010100000101000100001110001110111010000001000000000001
01000000000000110100000000100100100001010000010000000001001000100000001001010110001101001100000000101
00000010111000101000110110001001010001110000100000100010000000110000001000101001101001101000010001000
00110100101000000011100000000110001000110100100000110101000011110010001011001010010001100100100011101
01100001000000000001000000000000011001100100000001000000010100000010101000001000100001001010000110000
00110011010010100000101100000001010100000101010000000001001000001011100100000000010000000101100111000
00000000111100000001000001000100000010010001000010111010011000000010001001110001000110110000000101100
01100000110101001010100000111100000000111010000111000100110000100010000011001100001100000100100000011
10010000000011010100110000001000001000000100101000100100100100101100010111011001100101010000100011101
