00000000001000000001001000000000110000000000100010010001010000010000000100010010100111000001110011100
10010001011001001010011000010100111000000100100010000011110000000000001011001000000001011000011111011
00110001100001110000000110110000010000000000000010010010110000011000010010000100101000011011011000000
00010000001000110000000000000010000000010011110000000100010101000011001000111011110100100100010001111
01010001010001001010010000100000000000000000001010100010000110100001100000100111000001110100011000100
00000000000000100000001000010000000001101001000010100000101010000100001010000010001101010100010110001
00010001010000100010101000010001000000000100100010100101000101001101011000000010010100100111000000001
00001001101000000000101000001000101100000100100000100100000110010001000000011100110001110011101100000
00010010000001000000011000000010101100000011010010000000000000000000100100000000000100100001010000100
00110000010101010100100000010011001001000010001000101100111100010000100110001101000101100010000000000
10000001011000000101011000110011000010101110000100001010000000010111000000000010010100000000001100100
01100001100101010000001000001001011010000001110100000110001001010001010000111010000000100010101000100
10100001100000010000000110110010000001000010001000100000000000100010111010000110101010000100010010100
10001010001001001000000101011100010001000011000010000000010010001100001100100000000000101011000111100
01011001110000101001000001000010010010100000000101000000000000000001000001010101001100001100000011011
00100110110000101010000100010001011100011000000001110010001001100001001001100110000010001001101100001
00010000100000001101000101001000000010110010010101001011000100001110111001110000101000000100000001110
01011100011110000100000000110000000100111000100100001001000010000001010001000001000101000000100000100
10000100001000000000100010000000101000001100110000100000100001100011011000010000000000001001010101000
01000000001000000000100001111000001010100110010001000010010010001001101011000000000111000000001010000
00101010000000001100010000110010000100010001000000000000000001010000010101000000000000000000000010110
10011010111100100011100010111111010000011000101110100000001011000000000001001000010000011000011000000
00100001110000001111010000000001000100000000001101010000000001000000000010000100001100000000010100101
10111000000001100100000100011000000000000010000010000101001110000101001110000101110000000000000110000
00000101101000000101100010010100010010000001000010000000100110100100001000010010101100110000010000110
10110000010000101000001100111011010010000000000111001001000001100001001100010100100001011011000000101
00011000010000010000000010000001010000000000101110010000010000010110000111010110000000100000000000010
01100100110000110100101100000000111001000110000001001100101001000000010000000001000100100010010100010
00000000010010000100100100000000100000010000110000111010010100010000100000000000100000011001101000101
01000010000000010010000000000000010000100110100010101000100111000001100001011000010110000000001011010
01000000010000001000000000000000000111010000011101101000101000110000100100000000000100110010000000100
01011001000000000100000100110001000100110101011001000100000011001100001000100000100000100100001000010
10001101011110101100000100011110001000000101000010111000100001000011001101000010100100001010100000000
00000000000100001001001010000011000001011111010010000110001000001000000010000000011100111110000000000
00000000001000000000000010010011001011101000111110101000000100000001000000010000000001000100010100000
00000100001001000001000011100000001111100110100011110000000001000010000001001010000000001000000000000
00101001000010001000000111000000110100000100000100001100000000100011000010010100000101110000110000000
10000110100110000001010100000100000000010000100000101100101000100101001100000000001100100100010001011
11101000100000010100100001000000100101011001101010011000100010000000000000000100101010000011011101110
01010000000011110000100100000010000000011000101001000000000001000101100010010010100000000010100100010
10100000010011100110000010101000101000101000000010010001001010000000010010101100001010100000010000000
10010000101011000100001010101100100111000000010100101100101110000000001100101000000001110010000010000
10000001101101111000010101011100100001001011001000001000111010000111000000001000110000110010100000001
10011001000010000000000000100001000010100010000001010000000010110001000000100010100001101000010000001
10011100000100010010000000100000011101001010000000100010010000110100110110010000100100100000000000000
10111010101000100010000100010000000000101001010001001100100010000100000001110000000011101001111000011
11110000000000000001111110000010000111100000000000110001010110001100001000110110000000010010001110010
00111000010000001000100000000110001110111000001010101010110010101001101000000101000001010001101000100
10000001000001010011011100000000010011001000110011000110011000100010110000000001010101100011000010010
00010110100110000001000100000000100100001001000001100101101001011000001000000100100101000000001010010
10100110001000010100100010000000110100010000000001001000000001100001010110000000001000110000000001000
00000000100000000001001101100000111000011101100100100010001010110011001111000100011000010010000110001
00000000000000000110000000000000000110100011111100000100100000100001010001011100000000110001000100001
10000011000110000110010000000000111011000000010001000100100000000000011000001010001000001001000000000
01100000011000000001011001100010010111101101000000001010100000110001101001100111101000000000010010000
10001000000000010101100000100000000000011010001100000000100110000101100000001010010100000000011110011
01101001101111011100000101101000000100000001000000100100010100010100010100000100010000111010100001001
10110100010000010100001001101000110000101000000011010000010010100000000010000000000000000110000000000
00000000011001100110001000010000101011001110000100000010100100001001010000000001100000010000000101000
00000000010000000101010000000000100000010110101001000101000000000010111011101000100111000000111001000
00011000001000111111000010001000001000001001000101100001001000010000011000010000000000111001000001001
00000000100000111011000000001100100011100011000000011000011000010001000100001011000100001011110100100
00101010001001000010101100100000100001000100001100000000010000000011100010000010000000000000010001100
10011000100000010000010101000001001000000101000101000100110000100000000001100110000001001000110100101
00000111010010110100100010001010000011000111010000000110110001100000000010010000110101000001000100010
10010100000101001000101100000010001001100011010111001000000000000001011000001010000000000000001100010
10100000000000000000100001001010010000000001100001011001010011100001100000000100010010000010111010000
10110000000000000101001000000010001010000000010110100000010000001001010000000010100011100010100000000
00000000111100110001010001011010011110001000000010011110000100001000000111000001010000101001010000000
00100100110000000001001000001000001000000100000000101101000010110000001000100101010000000001000101001
00010000000000100000101010011000000000000001000010100000001100000100100001101100100101110000000100110
00010000100100010001000000011010010010000000011000100000000001000000001110100000000010001110111010110
00111001100001000100100101011010001001000001000000100100000000000010010110000010010010000100001010010
10100000111110000100000000010000000110000010000100101000001010010010000001001010000101000011100001000
00100001100101000101000000000010000000011000000000100001001111001100010000000010000000000000100000000
01001110000010110100000001100000001110000001101001100000010001110010000010000010000010001100100001010
01000111000100001000001000010111110100000000110011001001111000000100000000011010010010010000000110000
00000001010001100010111100010000000011100000101000000000000011100001101101001000001001110010100100000
00010111000110000111111100101010000100111000001000110010000010010100001000101010010100000000110100001
00110100000001000001100001001000000000001100000010110000010100110001000100000110000110000000000000000
11100011010100000100001000101100100010000010100000100000001111000000010000001001000010010101111100011
00100010011000000010011000010000000100000001001100000000100101010000100000101000100010010010010101101
00000010110001110000010000000000010000011100011000100001110100000011000001001010011010101011001000100
00001010000001010000000000001000000010010000010101101010000000100000000000010001000000010010001000101
00000011101010010101010100011000111010000010100001010010001110000001010000110000101000000100100000010
00010001101110011010001001010000000000001101001110110000001000000000000001000010001000000000001011100
00110101101000100100000100000110000100001110000000000100101000010011000110000111101100100111100001001
00001000100100100000000100000000010100010110010001101010010100000001100010011100100000001000000001100
01000000000000000100101000001000010100000011000000000110010000100100100000010100000000100010010000010
00001010000110010000000001000000000000101100001010001101001000000100000101100001010000010010000100110
00111100001110000001010000110101000101001111010100000000000010010111110001101001010000001000010100010
00000000110010010100000011011000000100000001010010000000000100100000110001010001011000000101000110010
01000000010100011001100011111010110001000001000100100000000000100001100101110000000101010001000001000
00110100100110000100000000010001000100010010001100000000100000001010000011000001001001000010100000000
00001000010001110000000110100011010000001000010100000010110100000000100000100000011000100000001001010
00000101010000110000001100001100001001001011001100011010000111001100011000001001100100000100000100010
00100011010000000010110111110011001100010101001001001000010100010101000000000010000000001001100001101
00001001011100010100100011010100000000101100010110110100000110001000000100011101000011010001010000100
10011000000100010001110000000101101100000010010000010100100110010000011100001011000000100101001000011
01000100001100000011000010000001010001101000000010000000000001100000010000100100000000001000100000000
01101010001101000010000001010111000101100111001010000001010000110100100001000101111001000101000000100
