00100100100000001000000000001111100001011110100101001100000001010000010001100111001000111010000100001
11001101101001101001000010000000001100011111100000101010001010100011000101000000100100010101110000000
00110100001010101000001001010000001000110000010001000010100000001100000000101100001110000010101100000
00000000001001000100000100000010011100000000000000000001000110000011010000000010000000000101101001000
00011001000000010001010100100010000011000000110000000000010000001010001001000001000000100000000010000
01000100001000000001010001000000001011010000110100000010001101000011000000101000010010100000010000101
01000010011000001011100000010100111010000001000100010011100010001000011101000101000000001011011010010
00010110010010111011001110000001101000010111000100001010101000100000010001010101000111010010111100100
00001101110000100100010000001011000110101101010011100100010011001101000111011001100100000000111000001
00100000011001100000100000011110001011000010100100011111100000000000010000010000100110000000111000100
01000110000010100000000001000101001100001000000010000100001000001100000010010100000101000110101010000
00000001100110101011010001001100000000000001100100000001000011110010000000010010001010110000100100011
01000001010000010011100000100000010000000011010000010000100000111000000000000000110010010000001100100
00010100001001000010000000101010001100100000000100100000000010110010000100001000101010000000100000110
00011110100010001000001000110110000001111011100101000010100000010100000000010010000011100100000110000
00001000010000000110100111011001010000100000000110100000000010100000010011000001000000000100000000001
00111111100000001000000000101001100001001000001000000100000110111010100000010011000011000101011011000
00111000010100001101101010010000000100010010010000110010000001000100100100001100010110010000001001100
00010000000111001001001001000010011000000100110010001111000000000001001001010100000110000001001011010
10110000100000010001000100000000000011000100011100010010100000000011110000110000110100000001110000010
01001000000000000101100001010100100011110001100111000001101000110000001000000011100001000110000000100
11001000000101101100100100000101000101001000000010000000000110000000110000000101001000010000000000110
10011100010100010100000000010000000000000000000010000010100000010000100010000011011010000100000000000
00001110111000100111000000001001000000000000111000010001001100110011010000100010000011000011001000111
00101010001100011110100000000010000001000000010000000001010001001010000000000000000011000101110101000
11100100011001110100100001110010010000000000001001001110011100100110001001100001001001010100100010001
00100100111000000000010100011001001011010000010100010000010010100011001001010000000100010100100000100
10000100000000100100100001001000011101100010000010100011110000101011110000000011011001100000010010011
10111000000001100000000000101100010010000010000100011000010100100100010000000100000101000011111101010
11100000011000000010001000000000001001100000100101010100100110010011000001110101001010011001000000000
00001110000000100100100000100100110001000110110011000000001110111000101001010000010011000000101000000
00000011111010000000000010101000000010110101100000000001011000010001000101100000011001010100000000000
01000000010100100000111001010101010101000101000110011000001010010010000111000000110100001011001000000
00000001111000000101110010000010001100000010010100000000000100000011011101010010010010001001000001000
00010000000000010000000100000001001100110100100100000001100001000000010000011101010100000001000000010
01001100001100100010000000100110010001100001011000010100010101010010000001011111010101011000000000111
00100101000111001000100100000000100100000000011000010001110101100101010011010101000100000001111000000
00001010000001001000000001110111000100010101100001010100101011001000010000000000011100010010000011001
01010000000001000010000000000000000110100110100001011000101000101000101110111001000000000000100001111
00000100000010101000000100111011000001100000001001000000001001000011000100010110010000100110000100001
10000110010000010010011111000100000010100101001001001001101011010000001011001001000101001000000010010
01000000000000101111001011100010011010010001000000101001001100100000000010000001000110000001000010100
10001110110100000000000011001001011000000001000001000010000000100001000101010011110001011010000000010
00000000010000000001011000000010101001010000001000100001001100011011010010000000001010001010000001110
10100000100100011001111001001001010100000000000000100010010010000000001100000000110000100000000000110
00111011000101000111000110100110010000000100001110001110010000000000100110010001111010011000001100010
00000011000000000000100000000001100001110111001101010100100000000000001000010100101001011000101000111
00000000100000000000000000001000000010000000000110001011001000001101000001000001001000000000100000100
00000000000000000010001001000100000001000100100000000000000001001000000010010000011111000000100001001
00011000001010000000101100001000100010000101100010001110100001100001000010000001101010101000010000011
00000110001000101101000100011000000001011010000000000001000101100001000000000110010000000000000010010
00000000100001010100010110100100001101001001011001010110001001001010010001001000010100000011000000001
01111000000010010000000000001010110011110000010001100000101001000100001000100001000101101011000101001
00000101001100000000111000000000000100001000001011001101101110010000010101101100101110001010001000001
00001000100100000101000001100001000010000100001100100000011000000000011110010001100000000010100000100
01011110000001010000001000100010010100011001110010000010000000000001001100010010000100010011000001011
00000110100001010100001000100001111101000010000100000010110000010010001000000100000000111110100011010
01101010000010110000100100000000110010001000001010010010001001111100101001001111100000010001000010001
00000001001100000001100000000001010010101010000010001100100001001001010010100001000010100000010000111
10000000000111001000000100100000110101000100111100000000000101000001001000100111011111001010000010111
00100110111000011000110100010010110010011100010010000000100001100100100011011101000000010001000010000
10001110000011010010000010100010010000000011100000001001010010001010111001000000101000011000000000010
10010010000000000100001011100000000000010101010100001110010010111001100100001111000110010110000001000
10000000100001001000001101000100010010110100000100000101000000100111000100000100110110100000001110001
00000000100000101011100000000100010100000111010001001010001010001000001000010010000000111000110100000
00001100110010110001100010001100010010000000001010010000001010000011000000000000000111001010001010101
01001011000010100000010010001010001001000001101000010111101011100000111110000001100000000010110000000
10000000100001100111010010010111100000010010000110010010000000001001100101000110000010100101000010000
01001100101100100001011010100010010001101001101000101000001111000001101000111000000000111000101000011
00110000011000100110000011000101010010000010000000010000001001101100000000011001001000001010000000000
00100100010010001001000100100001001010000000011110010011000010110000001000010001000110001110100001010
00000110010011100010011001011000000110010000100111000000010010001110010001000011000010010001110110000
00100110110110000000011000000000000100000000001000111010110100001000000011000001000000101000100010000
10000001000100000100100000011010100100000101101000101100000100000101010010001000100010010100101000000
00000010000000000000100101000010100000001100001001010100010001000101101000010110110000000111010100100
00110000101000001001100011000111000100000100010000000011010010010001000011111000100000010000011100111
10111101000100100101100011001000000000100000110101000000000010001101010010001000000001001000010001010
00001110100011100000010000000000000000100000100100001100100011101110001110000010000011000000010011000
10000000010000011000011101001111100100001000110000101100000000010100011000100000000100000011001111010
10000001000100001001010010110000001011100000001001000001000010110001000100001000100001001011010010000
10010010000010000011011110000000100111010110000111110111001000001001001101000110011110010111000010100
01001000000101010000101000010000001001100001000000000000001100110100011000100000000000010010010101000
00100111000000010000110001110111000000011001000010001111100100001001010000100001000001001000110100000
00000100000001010100101000010000010011010000000001100010000000101000100000000110010000010111000101110
01011001010001000000010100000010111000000010101110100110001001100000000010001000000000000000000100000
11100000001001010110000011010101001100100010011001100101001100000001110000000000100100010001000000000
00000000101000100010001011110011000110000000000001000101111000011101100010010000000100000000000111001
00100111000001010000000010001100100000001001000011000100000111101100010000001110010000100010100001100
01000100100000000100000100000010011101000000111001000100000011001100000000000010000100100000010111000
11110000001001100000101000001000010000101000101101001011110100100100101111010000001010001000010010100
10100010001000011000000000001000000100000111100000000100010001000011110000101100100100000010010001001
00100000000101000001000101111000101001001110001100110101001100001100000101010010101010100001011000000
10000000000000001000000000000110110101001011000100000001000100000001100000100100011010000010010000100
10011000001100000100000000000100011101001111001000000010001000000100011110000000000100100001100100000
00010110001001010101000001101000000010101101000001000000000001000000000001100010101011001000111000010
00001000010000001000000000110000010011001100100101100010111000001001000010000010010000100000000100010
01011100001101101110000000100010010001110110000000011011100100001101001100000100100000111010011110001
00100000100010100001000000001000000101000000000010000101010000100011100100100000001011010001000100000
10000100000010000000000011111000100000000100010001010100100000010000000111101010000010000000001010011
10000110001000000101001000010000010001000000000011100010011010100010001101000101000000100000011000010
01100100100101000000000010000000010000010010000010000010000011100100100000110000001000000001010000101
