00100001101000000001010001011000010001000001001011100100101000000010100000100000010001000000010000100
10001001001110001111001000000100100001001001010000001000000011000010011000001100001111000000001000011
00000010010010111010000101010100010111100000101000100000000000010110101001100000000000100010101010001
00010110000001000001000100000101001000010000011100000010010000010000100000000010110010000101000011110
00110000100000110000001010000011010100000110000000000000011000100000000000011100000111100000011101100
01101001110000000000101000100110000000100000000100000000100000101000010101000000010000111010000000001
00101000000000100000000001110000010001001010110000100000000010001000000000000000001111111001100101011
00000000000100101000011101010111100100100010010000100000011101110000000000000101000101010000100000001
10010100100000010110010010001000001010100001110000001001110110000010000000010000101010101000010000000
00001001110101000000010000000000000010110011001010010100100000100110010000001010110110100111100000001
00011010011111010100110000000011100000010000100000100110010111110100001000100010100000000000000110000
00000000100001000110100100100000000001000000100010000001010010100001010010101000001000001000110010000
11010000001000010001100001000110010011100100100000001011100000000010110111000000000000000000000000010
10011011001110000010000110101010100111010001010100010010010001111010000001100111001000000001001010000
01000100101010001000000010000100011101100000011000001100010110000000011001100100000011100110000000001
01000011111010000100000010010001110111110000101101100101011000000000111000010101000100101010000011100
10100100100010000000000000100000101100001000000001100001000000001011010000111000101100000000100101010
11110010010100000000111101000001101000001110010000001000000000001011101000000000001000000010010000001
10000100000011001101010011000000100100000010000010100111100100001110010000000100111000001111000011011
11000001000000000010000010000000100000010000110000010110000000001001001010000000001110000001000110101
00011000010100010000100010010101001001000000000000101001001000010010100100110001011010100000000001101
00000111101100010001011010000110001100000000010000010010101000000001111110010010010000010000010100001
01110000011001010000001000000001000001011101101110011100101010000011100001010111001111010000011010101
00000000000100000100111110110100101100001100110011101001001111100110010010001110100100101111000000010
00000000001000010000010011000010000101011010100010101000001000101100000000001111101011000001111101011
00010000010000100000000000010000000010000001000000001001000001111011000011000010010010100011000001010
00000000001000010001000100010101010110001000011100110100110001001011001000011001100001001001001110110
01100011000011000001100100000101001001110000101011001010010000100000101100000001001100000101100100111
01001001000011010000110000001100101011011111000100010000100101110000010101000001011010011000001000010
11000010011011000100010000100001100000100000010010001110010000010001001101010111110100000111000000000
01010100001000010000001000000010000010000000000000100100001000000110010000101010010000101000110100000
00010010010000101010111101001010001010010000000010010000000000010111001010000000010110101100000010000
11100000000010000000011001011000000001000010111100111000001010001010010000110000011000101100100000100
00000000011000100000010001000100100101000000000000000010100100010101111010111100011000100011000101000
01100100000000001000000100101010110000100000100111000001000010000001000100000100010010011000111010100
00000100000100001000101000100011100000000000001000011011110101000010001110000010000011000101010001011
00110010001001100101001101010001100001011110000100000000000100001000001100001110100000110010100001001
00011010000000000000001011000000000101010001000011110000110100000001000001010110010100000000110010101
01011111100000001001100000000000001010001011111000100001000101010000010110101100000001000001000000000
01001110110010000100010000000001110010001000110100010110001101000001000000100110110010100001000111100
01011011000000001100000100011000001000001011000000001100000000100001000001000001011010000010010001010
01110111000001100100010000101100111100010000110101010001001100001010101000010000010000100010010010001
10101011111000000110110010001001100010100110000000001010000000010001011011101001000001111000000010011
01000010100101110001100100100100010001000100001000110010000000000010100001100000000001011000100100000
11110001000000001000110001000010010100010011010001100000110101000000100110101000100100100000110001111
10100001000000001010000010000000011001100000000000001000000100010010010010010010001100011011011001100
10001100010100101110001000000100101001110001000100100001001001000011000010100001110000000100010100010
00101000010100001101111001100110001000000000000101001001110100011100000000010100000011000001000001001
01011001110100000001010000000000111000000000010001001000000000000001000010010000011000100001000010101
00101000000000000001110000000000000110010000001011110000100010010000000100001000000000110001010010101
10101100110010100111101000011001000001000000000100110001010100000000001000010000101000001110010000100
10010001000001100100011000000000000100010000110001100001011101101000000100000100000010100010000000010
01001100101100010000000000001000011110000100001101000000000000111000110000100000000001010000000100001
01000000010000001000000001001010000011101110101001000001001001010111001010111010101000010001000100100
00101110001100010100101000000100010101000100000000010001000010101001101100000100000001010110000001001
00000001100000000100010100110101000010110100000000000110011010001111011000101101100101000010011000010
10100010000001000011010001000000100010010001001100100010010001010101010000001001000000000010010000000
01101100010000011010000010000001101010100110011010011000010010010000000100000010001100000010100001100
00000010011101000110000101000101011000111100101000010000110100101110100001001110001100010000100010000
10101110000000000000011000101000000100000010100001000100100111011001000000010001100000000010000001000
00001000000001010010010100011101010010000010010011010001000000001001111000010000000000101010000011000
00000100000010000000000010000000100000110100000000000010110010010001010010000100000101010100010011001
00000001101110101100000000000000100010110010000101000011101000101010000000100101000000110000010000000
01010000101100000000100010100000000011000000011000100000100001100110000000000100001000011100001010000
10100000000001000101100001001001001100000000100010110000000001000010000000110111010110000001001001100
01101010110011010000000101100011000000101010100000100010000101010010010001000100000110110100011110110
00000010110010001001010001001010000000001100000001101111000101011000000100010011010000000110000000100
01001100000110001010000100100101011000100000010000000101000010011000110010001001000001000010000000000
10000001010011000000010100010100000100110001010000001100000001000000000100001111100100000000001010111
00101010100000000000000000000011001110001100101010000000000100001001001010100000101101001101010100010
11011100000001100100000010100100101000001010001001000000000000001100111001000110100101100000000110001
00000000000000001000001000000000010100000000111010001011000001001011011001000010000010000000100000000
01000010100000001010001010010110110010010100111010000010100110001100010111100000101000000001010110001
01010001101000101111001100110010001000001010000110000000110010000000101111000000001100000000000001110
10000000111100101000010100000001010000110011100000100000001011011011000001001000001101000000010000000
01000000001000110000000100001001100000110110100010011101000001000000010110001000000000010100101000010
10100000001000000000001000011100111001001000000001000000001010000000011000000010001010110010001010000
01000000100010001101000100000100000000100111100010000100010000001010101010000001111000000000101001001
00100000010000001000000001010010000000001001011101010001000001001110010000000001100000000110110001000
00000000010111001011100000101000000011010100001000000000110000100010000000110010100010100100011001111
10011100010000001010010010011110100001010101010000001000000100010000000010000100000000000001011111100
00101001010001110000000000101010010000101011110000000000110001010010010110100000010100110110110010000
00101000000000101101000000000000100110000011110101001001000000010100100001100001000000001001100100100
00010011000010000000100010000001001000010000000001010000000100001011000011101000000000110110000111101
10000101100011001101001100100000000100000100000000000110000100000010100000000100000000101000100100000
00010011001000100100000000101100001100000100111101010000011100101100011011111000000100010010000010111
00000000000100000000010010110010100100000000000011010110110001100010010000010100011101000010001001000
10000000000001000000000010100010101000100000011001001000100101010000010000000010001010000101111101001
00000011100010001011100110100001110000110110100011000100000000110011000101000000000000001001000100000
00101000000100100111000101100100010000000010011000011000011000000010000000001110011001000000100010001
01000100100011100100000100010110110000000001000000001000010001010010000100100000010001100001001001001
01000001010000011000000010011100011010010110111000001000010001000000001110010101011001001100100000110
00011000001010000011110011000011000011001000000000000000100001010010010111010000100000001100001000000
00000000001010100101010011000110100011001001100100000001100100000111000001000001001101101100010000000
00011000010000000100011011111100000000110101110000000000000000000001000001001000100000101001001100011
00000100001010010011001011100001100101101000010001110000101010100000101111101001010110101011000010100
01001011011000010001101100001011000001010000011100000001001001010011000010000100110100100100110000001
10000000010001000000010011000010100001000000010000001100010010000001000000011000101010101001000100000
01001000100100000011101000000000000000010010001000000010101000000000000000100011000000000010001100000
10001100011000010000001100010011110000000000100000110010100100110010000100010100010100000100100001000
00111000100000001010000000000000011001101011000000101000100000001100000000010100000010000010000010000
