 _____________________________________________________________________________________________________
| X  XX      X   X X  X    X X X X  XX                  X XXX    XXXX      XXX   XXX       XX XX  X X |
|X  X  X X     X      XXX     X  X X XXX  XX X   X         X    X X    X           XX    XX  X X XX  X|
|     XX      X  XX XXX X  X  X    X  X     X X XX     X X XX XXX X  X          X X   X X      X    X |
|      X             X     XX   XXX X X   XXXX         XX  X X XX  X X  X   X      X             X    |
|   X      XX X XX X    X    X     X                      XXXXXX    XX  X X  X  X      X     XX  X X  |
|XX    X X   XXX  X X X               X  XX X X X      X   XXX X    X    X  X   XX X X     X    X    X|
|     X X X     X X  X    XX  X   XX XXXXX  XXX X X   X       X X XX   X  XX         X  X X    X   X X|
|  X X      X XX       X  X    X X XX         X X  X   X    X   X     XXX X   XX XX X X      X  XX    |
|X X  X X X  X   X      XXX      X  X     X    X  XX      X  XXX    X          X           X  XX X    |
|X X X  XX    X XX   XX   X    X       XX          X   X X X X X     X   X X     X X   XX   X XXX  XX |
|X  X  XX    X  X         X      X X  XX  X  XX XX          X    X X XX   X     XXX X    X X  X    XX |
|XXXX  X X X       XXX  XX X   XX XXX    X XX          X  X   X X XXXXX       X XX X   X  X   X X     |
|X XX  X   X   X  XX   X X    X      XX     X   XX    X  XX XX XX    X XXXX XX X XX  X        XXX     |
|   X   X  XX XX       X X  XX XXX       XX     X     X X  X X XX   X         X   XXXX    X  X  X X  X|
|    X    XX    XX   X X   XX    X        XX    X X   XX  X   XX X  X XX      XX  XXXX   XX   XXXX X  |
|XX X  XXX XX XX  X    XX       X    X   X XX      X XX X   XX   X  X  XXX  X  X X    X            XXX|
|X         X XXX   XXX        XXXXX X X    X  XXXX      X X   XX   X   X     X    X  X X X X   X    X |
| X XX  X X          X    X    X  XX XX X  X X              XXXX      X    X       X X X   X  XX XX   |
|        XX    X   X X       XX   X        X   XXXX       X   X X     X   X X     X X           XXXX X|
|          XX  X   X   XX     X    X      X  X     X X      X    X        X  X  X  XXX       XX   X   |
| X     XX X XX X X    X                X                 XXX        XX  X  XXX    XXXX     X        X|
|  X X XXX  XXX  X     X         X  X X    X   X        X  XXX  X  X XX   X X X  X X XX     XX     X  |
|X X X        X          X X  XXXX   X         X   X    X    X X X     XX X            X  X    X  XX  |
|   XXXX    X  X X     XX  X            X   XX     XX    XX  X X  X   X  X            X XXXXXXX   XX  |
|        XX X   X     X  X       XX   X  X    X X XX   XX  X XX X X  X   X X      X   X   X   XX XXXX |
|X XX X   X   X X X       X  X X           XXXX      X        X              X      X  X      X  X   X|
| XX    XX    X      X      X  XX     XXX X XX X  X    X    X     X   X             XX   X X X    X   |
|   X  X XXX          XXXX   X     X  X      XXX X  X    X   X X X  X  X X  X XX          X    X  XX  |
|X     X        X       XX XX X XX   X        X X   X        XXX  XX XX  XX      X   XXX   X X   XX  X|
|  X XXX         XX X       XX   XXX  X                XX     X   XX     XX  X X X      X X      X   X|
|        XXXXX X    X  X   X  XX X   X      X X  X X  X  XXX XXX   X X    XX  XX     X    X   X  X    |
|XXXX    X  X     X   X  X XX  X       X    X     XX       XXX XXX      X X  XX        X X   X   X    |
| X X      XXX     X     X  X  XX    X       XXXX                  X       X X  X       X  XXX     XX |
|X    X X  X    X XXX      XXXX                 X X  XXXX        X         XX XXX XX      XXX  XXX X  |
|    X XXX  X    X  X X  X    XX X      XXX      X  X  X XX   X X  X   XX   X         XX      X      X|
|      X          X   X  XX X XX X    X   X  X    X XX   X     XX  XX X XX  XXX    XX  X     X       X|
|XX   X X XX X X    X X XX  X     XX X  XXX     X    XX   XX X    X X   X    X   XX   XX  XXXX   XX   |
| XX X        X   XX   XX      X     X  X XXXXX   XX   X     X    X X XX    XX    XX  X    X          |
|       X  X  X X  X      X X         X X X   XX    X     X X  X              XXXX      X            X|
| X       X     X   X X X X      X           XX  X   XX X X X  X  X X  X     XX X     XX    X XXX X X |
|X  XX X   X XX      X  X  XX  XX X          X  X XX  X X  X X XXX X  X      X X XX    X    X XX X    |
|     X XX X X   XX    X  X   XXX XX   XX  X  X X X X        X  XXX XX X   X     X  XX XX   XX XXXX  X|
| X XX X X      X X    X     X X XX X  XXXXX     X     X   XXX      XX XXX X X  X         X X  X XX X |
|X    X X  X   X      X  X  XX      X X  XX   XXXX X  X  X   X  X  XX  X    X  XXXX    XXX X      X  X|
| XXX   X  XXX   X           X       X XXX         X X   XXX    X X X XXX XX      XX   XX    XX  X    |
|             X  XX   X XX X  X    X XX        XX X     X    X  X      XX      X X  XXX       X     X |
|XX   X X  X  X       X     XX      X XX X XXXX   X  X          X XX    XX  X      X  XX   X          |
|  X  X   X                XX XXX  XX  X     X X XX XXX          X XXX   X    X  X  X XXX XX          |
|X  X     X  X   X X  X  XX     XXX X X X X XX  X X   XX   X            X XX XX     X    XX    X      |
|   X  XX        X   X     X X  XXX XX XX X       X X    X          X          X XX      XX XXX   X   |
| X XX XX X   X   X    X       X             X      XX   X X    X   XX X  X  XXXX     XX   X  XXXX  X |
|       XXX  X        X XXX    XXX X        X  X XX    X X X    XXX    X      XXXX XXXXX   X X    X   |
|   X X  X    XXXX X X   XXX X XXX X X XX  XX  X  XX  X  X X  X XXX X X   XXX    X X        X X       |
| XX XXX  X X  X             X X     X   X  X X X   XX X   X X   X   X X X  XX X XXX         X    X  X|
| X  X  X      XX   XXX X X     XXX XXX X     XX XX  XX   X  X      X  XX     X XX X       X  X X     |
| X   X     XX     XX  XXX           XX X  X   X X XX      X       XX   X  X X       X XX    X   X   X|
| X  X    X XXX    X     XX      X X  X      X  X   X   X      X       X  X   X   X XXX   X XXXXX X X |
| XXX X XX   X  X    X                XX    X  X       X        X X       X           X X XXX    XX   |
|X      X    X    XXX     X   X      X XXXX      X    X XX         XX      X  X   X     X XXX XX  X   |
|    X    X    XXXX     X     XX  X X XX    X   X     X  X  X XX      X X XX X       XX    XXX    X X |
|    X X           XXXX     X  XX X  X    X  X   XX     X X     X         X X X    XX     X XX X  X   |
|X  X   XXXX          X    X XXX    X    X XX X  X  XX        X   X XX        X    X    X X       X  X|
| XX XX X      X X          X       X XXX           X   X X  X  X    XX   XXX  XX                    X|
|XXX       X     X      X X X             XX XX X  XX    X    X                 XXXXX   X  XXX   X    |
|X       X      X XX          X       X    X           XX X             XX   X X   X X  X   X      XX |
| X X  X         X   X  XX    X  X                X  XX   X  XX X           XX          XX  X    XX   |
|            XXXX XX X        X       X   X      X     XX   XXXX  X X             X  X        XXX  X  |
|       X  X        X X  X     X  X XX XX        XX X XX      XX X       X   X  XX   X XXX X     X    |
|    X      XX   X       X X       X  X X   X  X  XX   X   XXX     XX            X           X XX   XX|
|XX XXXX X X  XX           X X  XX XX XXX    X            X  X     X               X    XX          X |
|X  X    XX    XXX X X   XXX  X X     XX X    X X XX X X XXXX         X  X   X X   XX    X X          |
| X  XX XX  X X X X     X          XX     XX X XXXX X XX       XX X    X        X X X     X X  X  X   |
|  X     X  X XX   X X XXXX X X    X  XX   XXX               X X  XXX     XX X X     XX     X      XX |
| XX  X          X  X      X X    X    X     XXX    XX    X X  X  X XX X X    XX  X          XX X XX  |
|  X   X   X     X XXX        X X     X    XX XXX X   X        XX XXX    XXX        X   X X    X    X |
|      X      X     X          X X XX       X X XX       XXXX   X  X X      X           X  X  X       |
|  X     XX X    X        XX  X     XXX       X     XXXX  XX       X XXX XX   XX     XX  XXX    X  X  |
|   XX   XX    X           X X XXXX XX     XX   X    X  X               X  X   X   X X          X     |
|XXX             X X X  X X  XX     X  XX       X   X    X  XXX XX XX   X XX X X X       X     X   X X|
| X          XX     X   X   X       X XX    X  X  XXX    X    XX X XX   XX X X X      XX   X  X    X  |
|     X  XX    X          XX   X X  X  X  XX X   X  X  X X  X     X X  X X  X X   X   XXX X   X      X|
|        X     X  XXXX  X                  X X  X    XX  XX XX   X    XX  X  X  XXX  X   X   XX   XX  |
| X   XX    XXX  XX         X XX XX  XX  X    XXX    X  X XX       X     XX XXX X X          X    XX  |
|   XX X     X    X  XX  XXX X     XX            X       X X   X X        XXX X   X  X     X  X  XXX  |
|  X  X X     X  XXX   X XXX    X  X    X        X   X   X     XX    X  XX      X   X   X  X     X X  |
|   XXX X         X    XXX X        X       X   X  XXX  XXXX  X X  X   X       XX      X      X    X  |
|               XX  X   X  XX XX  X    X     XXXX     XX       XX   X      X X   XX X  X  X  X X    XX|
|        XX    X  X  XX X X X  XXXX  X    X    XX   X X  X  XX   X  X X  X X    X  X   X      X X  X X|
| X   X      XX     X  X  X     X         X  XX       X    X  X X     X XX            X X   X   X  X  |
|X   X           XX     X        X  XX             XX     XX   X    X   X X  X X     X     XX X X XX  |
|X   XXX      XX   X   X   X  X   X    X  XXX          XXXX      XX  X   X   X  X X  X    X       XXXX|
|  XXXX XX X    XX   X    XX        XXXX  X     XX X     X X  X     X X             X   XX       X XXX|
| X   XX              X    X           X  X      XXXX X X   XXX      X X X      X  X       X   X   X  |
|   X X    X   X             X      X       X   X     X     XXX X      X   X  X X   X           XX    |
|  XX X X X  X         X X    X X    X     X X X   X     X  X         X XX  XXX            XX   X  X  |
| X  X       X X     X       X  XX        XX X  X       XXXX XX       XX   X    X       XX    X X   X |
|XXX    X             XX XX      XX  X X XXX  XX XXX  X   XXX  X   X X XXXX   X    X    X  X   X      |
| XX  X  X     X X    X  X     X X  X X  X  X  X      X   X X    X  X X X            X XX  X  X XX X  |
| XXXX X XX       X   X  X     X        X  X X X XX     X          XX    X    X X           X    X   X|
|   X      X      X  X    XXX      X   X        X  X X    X XX    X  XX  X  X X X         X XXXX     X|
|  XXX    X X   XX X    XX  XX    X  X  X  X XX X   X  X XXXX XX  X X       X   X X X     X     X  X  |
